17 17
0 0 0 0 0 0 0 2 2 2 2 0 2 0 2 0 2 
0 0 0 d 0 0 0 0 0 0 0 0 0 0 0 0 2 
0 0 c b 2 0 0 0 0 0 0 0 0 0 0 0 2 
0 b d 0 2 0 0 0 0 0 0 0 0 0 0 0 2 
0 0 2 2 2 0 1 0 0 0 0 0 0 0 0 0 2 
0 0 0 0 0 0 0 0 0 0 0 0 0 0 0 0 2 
0 0 0 0 1 0 0 0 1 1 1 1 0 0 0 0 2 
2 0 0 0 0 0 0 0 0 0 0 0 0 0 0 0 2 
2 0 0 0 0 0 1 0 0 0 1 0 0 0 0 0 2 
2 0 0 0 0 0 1 0 0 0 0 0 0 0 0 0 2 
2 0 0 0 0 0 1 0 1 0 0 0 1 0 0 0 2 
0 0 0 0 0 0 1 0 0 0 0 0 2 0 0 0 2 
2 0 0 0 0 0 0 0 0 0 1 2 0 0 0 c 2 
0 0 0 0 0 0 0 0 0 0 0 0 0 0 c b 2 
2 0 0 0 0 0 0 0 0 0 0 0 0 c a 0 2 
0 0 0 0 0 0 0 0 0 0 0 0 c d 0 0 c 
2 2 2 2 2 2 2 2 2 2 2 2 2 2 2 c 0 
COLORS 
0 0 0 0 0 0 0 0 0 0 0 0 0 0 0 0 0 
0 0 0 0 0 0 0 0 0 0 0 0 0 0 0 0 0 
0 0 1 0 0 0 0 0 0 0 0 0 0 0 0 0 0 
0 0 0 1 0 0 0 0 0 0 0 0 0 0 0 0 0 
0 0 0 0 0 0 0 0 0 0 0 0 0 0 0 0 0 
0 0 0 0 0 0 0 0 0 0 0 0 0 0 0 0 0 
0 0 0 0 0 0 0 0 0 0 0 0 0 0 0 0 0 
0 0 0 0 0 0 0 0 0 0 0 0 0 0 0 0 0 
0 0 0 0 0 0 0 0 0 0 0 0 0 0 0 0 0 
0 0 0 0 0 0 0 0 0 0 0 0 0 0 0 0 0 
0 0 0 0 0 0 0 0 0 0 0 0 0 0 0 0 0 
0 0 0 0 0 0 0 0 0 0 0 0 5 0 0 0 0 
0 0 0 0 0 0 0 0 0 0 0 5 0 0 0 0 0 
0 0 0 0 0 0 0 0 0 0 0 0 0 0 5 0 0 
0 0 0 0 0 0 0 0 0 0 0 0 0 5 5 0 0 
0 0 0 0 0 0 0 0 0 0 0 0 0 0 0 1 1 
0 0 0 0 0 0 0 0 0 0 0 0 0 0 0 1 0 
SPAWNPOINT 1 1 
EXIT 16 16 
TURRET CD 1 BV 4 POS 8 11 DIR 0.785398 W 1.88496 END
TURRET CD 1 BV 4 POS 11 8 DIR 0.785398 W 1.88496 END
TURRET CD 1 BV 4 POS 3 8 DIR 3.92699 W 1.88496 END
TURRET CD 1 BV 4 POS 8 3 DIR 3.92699 W 1.88496 END
BONUS POS 0 13 TYPE shield END
GENERATOR COLOR 5 POS 13 0 DIR 0 W 0 END
TURRET CD 1 BV 4 POS 14 15 DIR 3.92699 W 1.88496 END
TURRET CD 1 BV 4 POS 15 14 DIR 3.92699 W 1.88496 END
TURRET CD 1 BV 4 POS 3 12 DIR 4.71239 W 1.88496 END
TURRET CD 1 BV 4 POS 12 3 DIR 3.14159 W 1.88496 END
ROCKET_LAUNCHER CD 2 BV 3 DIRECTIONS 1 POS 0 15 DIR 0 W 0 END
ROCKET_LAUNCHER CD 2 BV 3 DIRECTIONS 1 POS 15 0 DIR 1.5708 W 0 END
LASER_CARRIER DIRECTIONS 5 POS 8 8 DIR 0.785398 W 0.3 END
GENERATOR COLOR 1 POS 15 15 DIR 0 W 0 END
EXIT 3 3 
END