50 50
0 0 0 0 0 1 0 0 0 0 0 0 0 0 0 0 0 0 1 0 0 0 0 0 0 0 0 0 0 0 1 1 1 1 0 0 0 0 0 0 0 0 0 0 0 0 0 0 0 0 
0 0 0 0 0 1 0 0 0 0 0 0 0 0 0 0 0 0 1 0 0 0 0 0 0 0 0 0 0 0 1 1 1 1 0 0 0 0 0 0 0 0 0 0 0 0 0 0 0 0 
0 0 0 0 0 1 0 0 0 0 0 0 0 0 0 0 0 0 1 1 1 1 1 1 1 1 1 0 0 0 1 1 1 1 1 1 1 0 1 0 1 0 1 1 1 1 1 1 1 1 
0 0 0 1 1 1 1 0 0 0 0 0 0 0 0 0 0 0 1 0 0 0 0 0 0 1 1 0 0 0 1 1 1 1 0 0 0 0 0 0 0 0 0 0 0 0 0 0 0 0 
0 0 0 2 1 1 1 0 0 0 0 0 0 0 0 0 0 0 1 0 0 0 0 0 0 0 0 0 0 0 0 0 0 0 0 0 0 0 0 0 0 0 0 0 0 0 0 0 0 0 
0 0 0 2 1 1 1 0 0 0 0 0 0 0 0 0 1 1 1 1 0 0 0 0 0 0 0 0 0 0 0 0 0 0 0 0 0 0 0 0 0 0 0 0 0 0 0 0 0 0 
0 0 0 2 2 1 1 0 0 0 0 0 0 0 0 0 1 1 1 1 0 0 0 0 0 0 0 1 1 0 0 0 0 1 0 0 0 0 0 0 0 0 0 0 0 0 0 0 0 0 
0 0 0 0 0 0 0 0 0 0 0 0 0 0 0 0 1 1 1 1 0 0 1 1 0 0 0 2 1 0 0 0 0 1 0 0 0 0 0 0 0 0 0 0 0 0 0 0 0 0 
0 0 0 0 0 0 0 0 0 0 0 0 0 0 0 0 1 1 1 1 0 0 2 1 0 0 0 0 0 0 0 1 1 1 1 0 0 0 0 0 0 0 0 0 0 0 0 0 0 0 
0 0 0 0 0 0 0 0 0 0 0 0 0 0 0 0 0 1 0 0 0 0 0 0 0 0 0 0 0 0 0 1 1 1 1 0 0 0 0 0 0 0 0 1 1 1 1 0 0 0 
0 0 0 0 0 2 1 1 1 0 0 0 0 0 0 0 0 1 0 0 0 0 0 0 0 0 0 0 0 0 0 1 1 1 1 1 0 1 0 1 0 1 1 1 1 1 1 0 0 0 
0 0 0 0 0 2 1 1 1 0 0 0 0 0 0 0 1 1 0 0 0 0 0 0 0 0 0 0 0 0 0 1 1 1 1 0 0 0 0 0 0 0 0 1 1 1 1 0 0 0 
1 1 1 1 1 1 1 1 1 1 1 1 0 0 0 0 1 0 0 0 0 0 0 0 0 0 2 2 1 0 0 0 1 0 0 0 0 0 0 0 0 0 0 1 1 1 1 0 0 0 
0 0 0 0 0 1 1 2 2 0 0 0 0 0 1 1 1 1 0 0 0 0 0 0 0 0 2 1 1 0 0 0 1 0 0 0 0 0 0 0 0 0 0 0 1 0 0 0 0 0 
0 0 0 0 0 0 0 0 0 0 0 0 0 0 1 1 1 1 1 2 0 0 0 0 0 0 0 1 0 0 0 0 1 0 0 0 0 0 0 0 0 0 0 0 1 0 0 0 0 0 
0 0 0 0 0 0 0 0 0 0 0 0 0 0 2 1 1 1 0 0 0 0 2 1 0 0 0 1 0 0 1 1 1 1 0 0 0 0 0 0 0 0 1 1 1 1 0 0 0 0 
0 0 0 0 1 0 0 0 0 0 0 0 0 0 2 1 1 1 0 0 0 0 2 1 0 0 0 1 0 0 1 1 1 1 1 1 1 1 1 1 1 1 1 1 1 1 0 0 0 0 
0 0 0 1 2 0 0 0 0 0 0 0 0 0 0 1 0 0 0 0 0 0 0 0 0 0 0 0 0 0 1 1 1 1 0 0 0 0 0 0 0 0 1 1 1 1 0 0 0 0 
0 0 0 0 0 0 0 0 0 0 0 0 0 0 0 1 0 0 0 0 0 0 0 0 0 0 0 0 0 0 1 1 1 1 0 0 0 0 1 1 0 0 1 1 1 1 0 0 0 0 
0 0 0 0 0 0 0 0 0 0 0 0 0 0 0 1 0 0 0 0 0 0 0 0 0 0 0 0 0 0 0 1 0 0 0 0 0 0 1 1 0 0 0 0 0 0 0 0 0 0 
0 0 0 0 0 0 0 0 0 0 0 0 0 0 0 1 0 0 0 0 2 0 0 0 0 0 0 0 0 0 0 1 0 0 0 2 0 0 0 0 0 0 0 0 0 0 0 0 0 0 
0 0 0 0 0 0 0 0 0 0 0 0 0 0 0 1 0 0 0 0 1 0 0 0 0 0 0 0 0 0 0 1 0 0 0 0 0 0 0 0 0 2 0 0 0 0 0 0 1 1 
0 0 0 0 0 0 0 0 0 0 2 2 1 1 0 1 0 0 1 1 1 1 0 0 0 0 0 0 0 0 0 1 0 0 0 0 0 0 0 0 0 0 0 0 0 0 0 1 1 1 
1 2 0 0 0 0 0 0 0 0 1 1 1 1 1 1 1 1 1 1 1 1 1 1 1 1 0 0 0 1 1 1 1 0 0 0 0 0 0 0 0 0 0 0 0 0 0 0 0 0 
1 1 1 1 0 0 1 1 1 1 1 1 1 1 0 0 0 0 1 1 1 1 0 0 0 0 0 0 1 1 1 1 1 0 2 0 0 0 0 0 0 0 0 0 0 2 0 0 0 0 
1 1 0 0 0 0 0 0 0 0 1 1 1 1 0 0 0 0 1 1 1 1 0 0 0 0 0 0 0 1 1 1 1 0 0 0 0 0 0 1 0 0 0 0 0 0 0 0 0 0 
1 1 0 0 0 0 0 0 0 0 0 0 0 0 0 0 0 0 0 0 1 0 0 0 0 0 0 0 0 1 1 1 1 0 0 0 0 0 1 1 1 0 0 0 0 0 0 1 1 1 
0 0 0 0 0 0 0 0 0 0 0 0 0 0 0 0 0 0 0 0 1 0 0 0 0 0 0 0 0 0 1 0 0 0 0 0 0 1 1 1 1 1 0 0 0 0 0 0 1 1 
0 0 0 0 0 1 1 1 1 0 0 0 0 0 0 0 0 0 0 0 0 0 0 0 0 0 0 0 0 0 1 0 0 0 0 0 0 0 1 1 1 0 0 0 0 0 0 0 0 0 
0 0 0 0 0 1 1 1 1 0 0 0 0 0 0 0 0 0 0 0 0 0 0 0 0 0 0 0 0 0 1 0 0 0 0 0 0 0 0 1 0 0 0 0 0 0 0 0 0 1 
1 1 1 1 1 1 1 1 1 0 0 0 0 0 0 0 0 0 0 0 0 0 0 0 0 0 0 0 0 0 1 0 0 1 0 0 0 0 0 1 0 0 0 0 0 0 0 0 0 1 
0 0 0 0 0 1 1 1 1 0 0 0 0 0 0 0 0 0 1 1 0 0 0 0 0 0 0 0 0 0 1 0 0 1 0 0 0 0 0 1 0 0 0 0 0 0 0 0 0 0 
0 0 0 0 0 0 0 1 0 0 0 0 0 0 0 0 0 0 1 1 0 0 0 0 0 0 0 0 0 0 1 0 0 0 0 0 0 0 0 0 0 0 0 0 0 0 1 1 0 0 
0 0 0 0 0 0 0 1 0 0 0 0 0 0 0 0 0 0 0 0 0 0 0 0 0 0 0 0 0 0 1 0 0 0 0 0 0 0 0 0 0 0 0 0 0 0 1 1 0 0 
0 0 0 0 0 0 0 1 0 0 1 1 1 1 0 0 0 0 0 0 0 0 0 0 0 0 0 0 0 1 1 1 1 0 0 0 0 0 0 0 0 0 0 0 0 0 0 0 0 0 
0 0 0 0 0 0 0 1 1 1 1 1 1 1 0 0 0 0 0 0 0 0 1 1 1 1 0 0 0 1 1 1 1 0 0 0 2 0 0 0 0 0 0 2 0 0 0 0 0 1 
0 0 0 0 0 0 0 0 0 0 1 1 1 1 1 1 1 1 1 1 1 1 1 1 1 1 1 1 1 1 1 1 1 0 0 0 0 0 0 0 0 0 0 0 0 0 0 0 0 1 
0 0 0 0 0 0 0 0 0 0 1 1 1 1 0 0 0 0 0 0 0 0 1 1 1 1 0 0 0 1 1 1 1 0 0 0 0 0 0 0 0 0 0 0 0 0 1 1 1 1 
0 0 0 0 0 0 0 0 0 0 0 0 0 0 0 0 0 0 0 0 0 0 1 1 1 1 0 0 0 0 0 0 0 0 0 0 0 0 0 0 0 1 0 0 1 1 1 1 1 1 
0 0 0 0 0 0 0 0 0 0 0 0 0 0 0 0 0 0 0 0 0 0 0 0 0 0 0 0 0 0 0 0 0 0 0 0 0 0 0 0 1 1 0 0 1 1 1 1 1 1 
0 0 0 0 0 0 0 0 0 0 0 0 0 0 0 0 0 0 0 0 0 0 0 0 0 0 0 0 0 0 0 0 0 0 0 0 1 1 1 1 1 1 1 1 1 1 1 1 1 1 
0 0 0 0 0 0 0 0 0 0 0 0 0 0 0 0 0 0 0 0 0 0 0 0 0 0 0 0 0 0 0 0 0 0 0 0 1 1 1 1 0 0 0 0 0 0 0 0 0 0 
0 0 0 0 0 0 0 0 0 0 0 0 0 0 0 0 0 0 0 0 0 0 0 0 0 0 0 0 0 0 0 0 0 0 0 0 1 1 1 1 0 0 0 0 0 0 0 0 0 0 
0 0 0 0 0 0 0 0 0 0 0 0 0 0 0 0 0 0 0 0 0 0 0 0 0 0 0 0 0 0 0 0 0 0 0 0 1 1 1 1 0 0 0 0 0 0 0 0 0 0 
0 0 0 0 0 0 0 0 0 0 0 0 0 0 0 0 0 0 0 0 0 0 0 0 0 0 0 0 0 0 0 0 0 0 0 0 0 0 0 0 0 0 0 0 0 0 0 0 0 0 
0 0 0 0 0 0 0 0 0 0 0 0 0 0 0 0 0 0 0 0 0 0 0 0 0 0 0 0 0 0 0 0 0 0 0 0 0 0 0 0 0 0 0 0 0 0 0 0 0 0 
0 0 0 0 0 0 0 0 0 0 0 0 0 0 0 0 0 0 0 0 0 0 0 0 0 0 0 0 0 0 0 0 0 0 0 0 0 0 0 0 0 0 0 0 0 0 0 0 0 0 
0 0 0 0 0 0 0 0 0 0 0 0 0 0 0 0 0 0 0 0 0 0 0 0 0 0 0 0 0 0 0 0 0 0 0 0 0 0 0 0 0 0 0 0 0 0 0 0 0 0 
0 0 0 0 0 0 0 0 0 0 0 0 0 0 0 0 0 0 0 0 0 0 0 0 0 0 0 0 0 0 0 0 0 0 0 0 0 0 0 0 0 0 0 0 0 0 0 0 0 0 
0 0 0 0 0 0 0 0 0 0 0 0 0 0 0 0 0 0 0 0 0 0 0 0 0 0 0 0 0 0 0 0 0 0 0 0 0 0 0 0 0 0 0 0 0 0 0 0 0 0 
SPAWNPOINT 1 1 TURRET  POS 9 2 DIR 0 W 3.141592653589793 CD 1 BV 4 END
 TURRET  POS 13 7 DIR 0 W 3.141592653589793 CD 1 BV 4 END
 TURRET  POS 10 6 DIR 0 W 3.141592653589793 CD 1 BV 4 END
 TURRET  POS 16 26 DIR 3.1101767270538954 W 3.141592653589793 CD 1.1 BV 4.3 END
 TURRET  POS 11 31 DIR 3.1101767270538954 W 3.141592653589793 CD 1.1 BV 4.3 END
 TURRET  POS 20 17 DIR 3.1101767270538954 W 3.141592653589793 CD 1.1 BV 4.3 END
 TURRET  POS 29 18 DIR 3.1101767270538954 W 3.141592653589793 CD 1.1 BV 4.3 END
 TURRET  POS 22 11 DIR 3.1101767270538954 W 3.141592653589793 CD 1.1 BV 4.3 END
 TURRET  POS 26 15 DIR 3.1101767270538954 W 3.141592653589793 CD 1.1 BV 4.3 END
 TURRET  POS 23 4 DIR 3.1101767270538954 W 9.42477796076938 CD 0.5 BV 4 END
 TURRET  POS 30 10 DIR 1.6964600329384885 W 9.42477796076938 CD 0.5 BV 4 END
 TURRET  POS 25 9 DIR 1.6964600329384885 W 9.42477796076938 CD 0.5 BV 4 END
 TURRET  POS 17 20 DIR 1.6964600329384885 W 9.42477796076938 CD 0.5 BV 4 END
 TURRET  POS 27 4 DIR 1.6964600329384885 W 9.42477796076938 CD 0.5 BV 4 END
 TURRET  POS 24 19 DIR 1.6964600329384885 W 9.42477796076938 CD 0.5 BV 4 END
 TURRET  POS 36 22 DIR 4.71238898038469 W -1.5707963267948966 CD 2 BV 8 END
 TURRET  POS 44 29 DIR 4.71238898038469 W 1.8849555921538759 CD 2 BV 8 END
 TURRET  POS 35 29 DIR 5.340707511102648 W 1.8849555921538759 CD 2 BV 8 END
 TURRET  POS 42 24 DIR 5.340707511102648 W -1.8849555921538759 CD 2 BV 8 END
 TURRET  POS 40 33 DIR 5.340707511102648 W -1.2566370614359172 CD 2 BV 8 END
 ROCKET_LAUNCHER  POS 28 35 DIR 3.7699111843077517 W 0 CD 1 BV 4 DIRECTIONS 1 END
 ROCKET_LAUNCHER  POS 29 27 DIR 2.9845130209103035 W 0 CD 0.9 BV 4 DIRECTIONS 1 END
 ROCKET_LAUNCHER  POS 29 29 DIR 3.1101767270538954 W 0 CD 1.1 BV 4.3 DIRECTIONS 1 END
 ROCKET_LAUNCHER  POS 16 34 DIR 3.1101767270538954 W 3.141592653589793 CD 1.1 BV 4.3 DIRECTIONS 3 END
 ROCKET_LAUNCHER  POS 37 0 DIR 1.5707963267948966 W 0 CD 3 BV 1 DIRECTIONS 1 END
 ROCKET_LAUNCHER  POS 39 0 DIR 1.5707963267948966 W 0 CD 2 BV 1.2 DIRECTIONS 1 END
 ROCKET_LAUNCHER  POS 41 0 DIR 1.5707963267948966 W 0 CD 1.8 BV 1.7 DIRECTIONS 1 END
 ROCKET_LAUNCHER  POS 36 15 DIR 4.71238898038469 W 0 CD 1.8 BV 1.7 DIRECTIONS 1 END
 ROCKET_LAUNCHER  POS 40 15 DIR 4.71238898038469 W 0 CD 1.9 BV 1.9 DIRECTIONS 1 END
 ROCKET_LAUNCHER  POS 38 15 DIR 4.71238898038469 W 0 CD 2 BV 2 DIRECTIONS 1 END
 ROCKET_LAUNCHER  POS 48 25 DIR 3.9269908169872414 W 0 CD 1 BV 4 DIRECTIONS 1 END
 ROCKET_LAUNCHER  POS 34 17 DIR 0.7853981633974483 W 0 CD 0.95 BV 4 DIRECTIONS 1 END
 ROCKET_LAUNCHER  POS 31 29 DIR -0.7853981633974483 W 0 CD 1.05 BV 4 DIRECTIONS 1 END
 ROCKET_LAUNCHER  POS 40 35 DIR -0.7853981633974483 W 0 CD 0.9 BV 4 DIRECTIONS 1 END
 LASER_CARRIER  POS 7 19 DIR 0 W 0.3141592653589793 DIRECTIONS 8 END
 BONUS POS 2 15 TYPE shield END
 BONUS POS 1 28 TYPE shield END
 BONUS POS 21 1 TYPE shield END
