50 50
0 0 0 0 0 0 0 1 0 0 0 0 0 0 0 0 0 0 1 0 0 0 0 0 0 0 0 0 0 0 0 0 0 0 0 0 0 0 0 0 0 0 0 0 1 0 0 0 0 0 
0 0 0 0 0 0 0 1 0 0 0 0 0 0 0 0 0 1 0 0 0 0 0 0 0 0 0 0 0 0 0 0 0 0 0 0 0 0 0 0 0 0 0 0 0 1 0 0 0 0 
0 0 0 0 0 0 0 1 0 0 0 0 0 0 0 0 1 0 0 0 0 0 0 0 1 0 0 0 0 0 0 0 0 0 0 0 0 0 0 0 0 0 0 0 0 0 1 0 0 0 
0 0 0 2 0 0 2 1 1 1 0 0 0 0 0 0 0 0 0 0 0 0 0 0 0 1 0 0 0 0 0 0 0 0 0 0 0 0 0 0 0 0 0 0 0 0 0 1 0 0 
0 0 0 0 0 0 0 0 0 1 0 0 0 0 0 0 0 0 0 0 0 0 0 0 0 0 1 0 0 0 0 0 0 0 0 0 0 0 0 0 0 0 0 0 0 1 0 1 1 0 
0 0 0 0 0 0 0 0 0 1 1 1 1 0 0 0 1 0 0 0 0 0 0 0 0 0 1 1 0 0 0 0 0 0 0 0 0 0 0 0 0 0 0 0 0 0 0 0 0 1 
0 0 0 2 0 0 0 0 0 2 0 0 1 1 0 0 1 0 0 0 0 0 0 0 0 0 0 1 0 0 0 0 0 0 0 0 0 0 0 0 0 0 0 0 0 2 0 0 0 0 
1 1 1 1 0 0 0 0 0 0 0 0 0 1 1 1 0 0 0 0 0 0 0 0 0 0 0 0 1 1 0 0 0 0 0 0 0 0 0 0 0 0 0 0 0 0 0 0 0 0 
0 0 0 1 0 0 0 0 0 0 0 0 0 0 1 1 0 0 0 0 0 0 0 0 0 0 0 0 0 1 0 0 0 0 0 0 0 0 0 0 0 1 0 2 0 1 0 0 0 0 
0 0 0 1 1 1 2 0 0 2 0 0 0 0 1 0 0 0 0 0 0 0 0 0 0 2 0 0 0 0 1 1 0 0 0 0 0 0 0 0 0 0 0 0 0 0 0 0 0 0 
0 0 0 0 0 1 0 0 0 0 0 0 0 0 0 0 0 0 0 0 0 0 0 0 2 0 0 0 0 0 0 0 1 0 0 0 0 0 0 0 0 2 0 0 0 0 0 0 0 0 
0 0 0 0 0 1 0 0 0 0 0 0 0 0 0 0 0 0 0 0 0 0 0 2 0 0 0 0 0 0 0 0 1 0 0 0 0 0 0 0 0 0 0 0 0 0 0 0 0 0 
0 0 0 0 0 1 1 0 0 0 0 0 0 0 0 0 0 0 0 0 0 0 0 0 0 0 0 0 0 0 0 0 0 1 0 0 0 1 0 2 0 1 0 0 0 0 0 0 0 0 
0 0 0 0 0 0 1 1 0 0 0 0 0 2 0 0 0 0 0 0 0 1 0 0 0 0 0 0 0 0 0 0 0 0 1 0 0 0 0 0 0 0 0 0 0 0 0 0 0 0 
0 0 1 0 0 0 0 0 1 0 0 0 0 0 0 0 0 0 0 0 1 1 0 0 0 0 0 0 2 0 0 0 0 0 0 1 1 1 0 0 0 0 0 0 0 0 0 0 0 0 
0 1 0 0 0 0 0 0 0 1 0 0 0 0 0 2 0 0 0 0 0 1 0 0 0 0 0 0 0 0 0 0 0 0 0 1 1 1 0 0 0 0 0 0 0 0 0 0 0 0 
1 0 0 0 0 0 0 0 0 0 1 0 0 0 0 0 0 0 0 0 0 0 1 0 0 0 0 0 0 0 0 0 0 0 1 1 1 1 0 0 0 0 0 0 0 0 0 0 0 0 
0 0 0 0 0 0 0 0 0 0 0 1 0 0 0 0 0 2 0 0 0 0 0 1 0 0 0 0 0 0 0 0 0 1 0 0 0 0 1 0 0 0 0 0 0 0 0 0 0 0 
0 0 0 0 0 0 0 0 0 0 0 0 1 0 0 0 0 0 0 0 0 0 0 0 1 0 0 0 0 0 0 0 0 0 0 0 0 0 0 1 1 0 0 0 0 0 0 0 0 0 
0 0 0 0 0 0 0 0 0 0 0 0 0 1 0 0 0 0 0 0 0 0 0 0 0 1 0 0 0 0 1 0 0 0 0 0 0 0 0 0 0 1 0 0 0 0 0 0 0 0 
0 0 0 0 0 0 0 0 0 0 0 0 0 0 1 0 0 0 0 0 2 0 0 0 0 0 1 0 0 1 1 0 0 0 0 0 0 0 0 0 0 0 1 0 0 0 0 0 0 0 
0 0 2 0 0 0 0 0 0 0 0 0 0 0 0 1 0 0 0 0 0 0 0 0 0 0 0 1 1 1 0 0 0 0 0 0 0 0 0 0 0 0 0 1 0 0 0 0 0 1 
0 0 1 0 0 0 0 0 0 0 0 0 0 0 0 1 1 1 0 0 0 0 2 0 0 0 0 0 1 1 0 0 0 0 0 0 2 0 0 0 0 0 0 0 1 0 0 0 0 0 
0 0 1 0 0 0 0 0 0 0 0 0 0 0 0 1 1 0 0 0 0 0 0 0 0 0 0 0 1 0 0 0 0 0 0 0 0 0 0 0 0 0 0 0 1 0 1 0 0 0 
0 0 1 0 0 0 0 0 0 0 0 0 0 0 0 1 0 0 0 0 0 0 0 0 2 0 0 0 0 0 0 0 0 0 0 0 0 0 0 0 0 2 0 0 0 1 0 0 0 0 
0 0 2 0 0 0 0 0 0 0 0 0 0 0 0 1 0 0 0 0 0 0 0 0 0 0 0 0 0 0 0 0 0 0 0 0 0 0 0 0 0 0 0 0 0 1 0 0 0 0 
0 0 0 0 0 0 0 0 0 0 0 0 0 1 0 0 0 0 0 0 0 0 0 0 0 0 2 0 0 0 0 0 0 0 0 0 0 0 0 0 0 0 0 0 0 1 0 0 0 0 
0 0 0 0 0 0 0 0 0 0 0 0 1 0 0 0 0 0 0 0 0 1 0 0 0 0 0 0 0 0 0 0 0 1 0 0 0 0 0 0 0 0 0 0 0 1 0 0 0 0 
0 0 0 0 0 0 0 0 0 0 0 1 0 0 0 0 0 0 0 0 0 0 1 0 0 0 0 0 2 0 0 0 0 0 1 0 0 0 0 2 0 0 0 0 0 1 0 0 0 0 
0 0 0 0 0 0 0 0 0 0 0 0 0 0 0 0 0 0 0 0 0 0 0 1 0 0 0 0 0 0 0 0 0 0 0 1 0 0 0 1 0 0 0 0 0 1 0 0 0 0 
0 0 0 0 0 0 0 0 0 1 0 0 0 0 0 0 0 0 0 0 0 0 0 0 1 0 0 0 0 0 2 0 0 0 0 0 1 0 1 0 0 0 0 0 1 0 0 0 0 0 
0 0 0 0 0 0 0 0 0 1 0 0 0 0 0 0 0 0 0 0 0 0 0 0 0 1 0 0 0 0 0 0 0 0 0 1 1 1 0 0 0 0 0 1 0 0 0 0 0 1 
1 1 0 0 2 0 0 1 1 1 0 0 0 0 0 0 0 0 0 0 0 0 0 0 0 0 1 0 0 0 0 0 2 0 0 0 0 0 0 0 0 0 1 0 0 0 0 0 1 0 
1 0 0 0 0 0 0 0 0 1 0 0 0 0 0 0 0 0 0 0 0 0 0 0 0 0 0 1 1 0 0 0 0 0 0 0 0 0 0 0 0 1 0 0 0 0 0 1 0 0 
1 1 0 0 0 0 0 0 0 1 0 0 0 0 0 0 0 0 0 0 0 0 0 0 0 0 0 1 0 0 0 0 0 0 0 0 0 0 0 1 1 0 0 0 0 0 1 0 0 0 
0 1 1 0 0 0 0 0 0 0 1 0 0 0 0 0 0 0 0 0 0 0 0 0 0 0 0 1 0 0 0 0 0 0 0 1 1 1 1 1 1 0 0 0 0 1 0 0 0 0 
0 1 1 1 0 0 0 0 0 0 0 1 1 0 0 0 0 0 0 0 0 0 0 0 0 2 0 0 1 0 0 0 0 0 0 0 0 0 0 0 0 1 1 0 1 0 0 0 0 0 
0 1 0 1 0 0 0 0 0 0 0 0 0 1 0 0 0 0 0 0 0 0 0 0 0 0 0 0 0 0 0 0 0 1 1 1 1 1 1 0 0 1 1 1 0 0 0 0 0 0 
0 0 0 0 0 0 0 0 0 0 0 0 0 0 1 0 0 0 0 0 0 0 0 0 2 0 0 0 0 0 0 0 1 1 1 0 0 0 0 0 0 0 1 0 0 0 0 0 0 0 
0 0 0 0 0 0 0 0 0 0 0 0 0 0 0 1 0 0 0 0 0 0 1 0 0 0 0 0 0 0 0 0 0 2 0 0 0 0 0 0 0 1 0 0 0 0 0 0 0 0 
0 0 0 0 0 0 0 0 0 0 0 0 0 0 0 1 0 0 0 0 0 0 0 0 0 2 0 0 0 0 0 0 0 0 0 0 0 0 0 0 1 0 0 0 0 0 0 0 0 0 
0 0 0 0 0 0 0 0 0 0 0 0 0 0 0 1 1 0 0 0 1 0 0 0 0 0 0 0 0 0 0 0 2 0 0 0 0 0 0 1 0 0 0 0 0 0 0 0 0 0 
0 0 0 0 0 0 0 0 0 0 0 0 0 0 1 0 0 1 0 0 0 0 0 0 0 0 0 2 0 0 2 0 0 0 0 0 0 1 1 0 0 0 0 0 0 0 0 0 0 0 
0 0 0 0 0 0 0 0 0 0 0 0 0 0 1 0 0 0 1 0 0 0 0 0 0 0 0 0 0 0 0 0 0 0 0 0 1 0 0 0 0 0 0 0 0 0 0 0 0 0 
0 0 0 0 0 0 0 0 0 0 0 0 0 1 0 0 0 0 0 1 0 0 0 0 0 0 0 0 0 0 0 0 0 0 1 1 0 0 0 0 0 0 0 0 0 0 0 0 0 0 
1 0 0 0 0 0 0 0 1 0 0 0 0 1 1 1 1 1 1 1 1 1 1 1 2 1 1 1 1 1 2 1 1 1 1 0 0 0 0 0 0 0 0 0 0 0 0 0 0 0 
0 0 0 0 0 0 0 0 0 1 0 0 0 0 0 1 0 0 0 0 0 2 0 0 0 0 0 2 0 0 0 0 0 2 0 0 0 0 1 0 0 0 0 0 0 0 0 0 0 0 
0 0 0 0 0 0 0 0 0 1 0 0 0 0 0 0 0 0 0 0 0 0 0 0 0 0 0 0 0 0 0 0 0 0 0 0 0 0 1 0 0 0 0 0 0 0 0 0 0 0 
0 0 0 0 0 0 0 0 0 1 0 0 0 0 0 0 0 0 2 0 0 0 0 0 2 0 0 0 0 0 2 0 0 0 0 0 0 0 1 0 0 0 0 0 0 0 0 0 0 0 
0 0 0 0 0 0 0 0 0 0 0 0 0 1 1 1 1 2 2 2 2 2 2 2 2 2 2 2 2 2 2 2 2 2 2 2 2 2 1 0 0 0 0 0 0 0 0 0 0 0 
SPAWNPOINT 1 1 TURRET  POS 19 10 DIR 0.7853981633974483 W 6.283185307179586 CD 0.4 BV 5 END
 TURRET  POS 13 17 DIR 0.7853981633974483 W 6.283185307179586 CD 0.8 BV 10 END
 TURRET  POS 17 25 DIR 0.7853981633974483 W 6.283185307179586 CD 0.3 BV 5 END
 TURRET  POS 40 36 DIR 3.141592653589793 W 0 CD 0.1 BV 30 END
 TURRET  POS 31 24 DIR 3.141592653589793 W 9.42477796076938 CD 0.2 BV 6 END
 TURRET  POS 34 24 DIR 3.141592653589793 W 9.42477796076938 CD 0.8 BV 10 END
 TURRET  POS 38 34 DIR 3.141592653589793 W 6.283185307179586 CD 0.8 BV 10 END
 TURRET  POS 39 21 DIR 3.141592653589793 W 6.283185307179586 CD 1 BV 10 END
 TURRET  POS 26 17 DIR 3.141592653589793 W 9.42477796076938 CD 0.2 BV 6 END
 TURRET  POS 29 10 DIR 3.141592653589793 W 9.42477796076938 CD 0.2 BV 6 END
 TURRET  POS 25 11 DIR 3.141592653589793 W 9.42477796076938 CD 0.8 BV 10 END
 TURRET  POS 31 46 DIR 3.141592653589793 W 6.283185307179586 CD 2 BV 3 END
 TURRET  POS 16 0 DIR 3.141592653589793 W 6.283185307179586 CD 0.8 BV 7 END
 TURRET  POS 43 18 DIR 3.141592653589793 W 6.283185307179586 CD 0.7 BV 7 END
 TURRET  POS 48 15 DIR 3.141592653589793 W 6.283185307179586 CD 0.7 BV 7 END
 TURRET  POS 48 36 DIR 3.141592653589793 W 6.283185307179586 CD 1 BV 7 END
 TURRET  POS 0 13 DIR 3.141592653589793 W 6.283185307179586 CD 1 BV 9 END
 TURRET  POS 21 29 DIR 3.9269908169872414 W 0 CD 0.1 BV 30 END
 TURRET  POS 3 29 DIR 3.9269908169872414 W 6.283185307179586 CD 0.8 BV 8 END
 TURRET  POS 5 34 DIR 3.9269908169872414 W 6.283185307179586 CD 0.8 BV 8 END
 ROCKET_LAUNCHER  POS 28 39 DIR 3.141592653589793 W 0.5340707511102649 CD 0.4 BV 5 DIRECTIONS 5 END
 ROCKET_LAUNCHER  POS 37 47 DIR 3.141592653589793 W 0 CD 1 BV 4 DIRECTIONS 1 END
 ROCKET_LAUNCHER  POS 6 23 DIR 3.9269908169872414 W 0.4084070449666731 CD 1 BV 4 DIRECTIONS 5 END
 LASER_CARRIER  POS 8 4 DIR 0.7853981633974483 W -0.3141592653589793 DIRECTIONS 8 END
 LASER_CARRIER  POS 4 8 DIR 0.7853981633974483 W 0.3141592653589793 DIRECTIONS 8 END
 LASER_CARRIER  POS 15 9 DIR 0.7853981633974483 W 0 DIRECTIONS 1 END
 LASER_CARRIER  POS 17 23 DIR 0.7853981633974483 W 0 DIRECTIONS 1 END
 LASER_CARRIER  POS 29 23 DIR 0.7853981633974483 W 0 DIRECTIONS 1 END
 LASER_CARRIER  POS 28 34 DIR 0.7853981633974483 W 0 DIRECTIONS 1 END
 LASER_CARRIER  POS 39 49 DIR 3.141592653589793 W 0.3141592653589793 DIRECTIONS 5 END
 LASER_CARRIER  POS 2 37 DIR 1.5707963267948966 W 0 DIRECTIONS 1 END
 LASER_CARRIER  POS 0 38 DIR 1.5707963267948966 W 0.4084070449666731 DIRECTIONS 4 END
 ROBOT  POS 20 4 DIR 3.141592653589793 W 6.283185307179586 BV 15 CD 1.5 MF 0 SHIELDS 1 END
 ROBOT  POS 17 31 DIR 3.141592653589793 W 6.283185307179586 BV 15 CD 1.5 MF 5 SHIELDS 0 END
 ROBOT  POS 26 23 DIR 3.141592653589793 W 6.283185307179586 BV 6 CD 1.5 MF 0 SHIELDS 5 END
 ROBOT  POS 36 6 DIR 3.141592653589793 W 6.283185307179586 BV 5 CD 1 MF 30 SHIELDS 0 END
 ROBOT  POS 40 2 DIR 3.141592653589793 W 6.283185307179586 BV 5 CD 1 MF 30 SHIELDS 0 END
 ROBOT  POS 32 2 DIR 3.141592653589793 W 6.283185307179586 BV 5 CD 1 MF 30 SHIELDS 0 END
 ROBOT  POS 45 32 DIR 3.141592653589793 W 6.283185307179586 BV 5 CD 1 MF 30 SHIELDS 0 END
 ROBOT  POS 0 48 DIR 1.5707963267948966 W 0.4084070449666731 BV 7 CD 1 MF 0 SHIELDS 0 END
 EXIT 49 49
 BONUS POS 9 1 TYPE shield END
 BONUS POS 1 1 TYPE shield END
 BONUS POS 1 1 TYPE shield END
 BONUS POS 1 1 TYPE shield END
 BONUS POS 1 1 TYPE shield END
 BONUS POS 1 1 TYPE shield END
 BONUS POS 1 9 TYPE shield END
