25 25
0 0 0 0 0 0 0 0 2 0 0 0 0 0 0 0 0 0 2 0 0 0 0 2 2 
0 0 0 0 0 0 0 0 0 0 0 0 0 2 0 0 0 0 0 0 0 0 0 2 2 
0 0 0 0 0 0 0 0 0 0 0 0 0 0 0 0 0 0 0 0 0 0 0 0 0 
0 0 0 0 0 2 0 0 0 0 0 0 0 0 0 0 0 2 2 0 0 0 0 0 0 
2 2 1 1 1 1 1 1 2 2 2 1 1 1 1 1 1 1 2 0 0 0 2 0 0 
0 0 0 0 0 0 2 0 0 0 0 0 0 0 0 0 0 1 0 0 0 0 0 0 0 
0 0 0 0 0 0 0 0 0 0 0 0 0 0 0 0 0 1 0 0 0 0 0 0 0 
0 0 0 2 0 0 0 0 0 0 0 0 0 2 0 0 0 1 0 0 0 0 0 0 0 
0 0 0 0 0 0 0 0 0 0 0 0 0 2 0 0 0 1 0 0 0 0 0 2 0 
0 0 0 0 0 0 0 0 0 0 0 0 0 0 0 0 0 2 0 0 2 2 2 2 0 
0 0 0 0 1 1 2 2 1 1 1 1 1 0 0 0 0 2 0 0 0 2 0 0 0 
0 0 0 0 1 0 0 0 0 0 0 0 2 0 0 0 0 2 0 0 0 0 0 0 0 
0 0 0 0 1 0 0 0 0 0 0 0 2 0 0 0 0 1 0 0 0 0 0 0 0 
0 0 0 0 1 0 0 0 0 0 0 0 2 0 0 0 0 1 0 0 0 0 0 0 0 
1 2 0 0 1 0 0 0 0 0 0 0 0 0 0 0 0 1 0 0 2 2 0 0 0 
1 2 0 0 2 0 0 0 0 0 0 0 0 0 0 0 0 1 0 0 2 2 0 0 0 
0 0 0 0 2 0 0 0 0 2 2 0 0 0 0 0 0 1 0 0 0 0 0 0 0 
0 0 0 0 1 0 0 0 0 2 2 0 0 0 0 0 0 1 0 0 0 0 0 0 0 
0 0 0 0 1 0 0 0 0 0 0 0 0 0 0 0 2 2 0 0 0 0 0 0 2 
0 0 0 0 1 1 1 1 1 1 1 1 1 1 1 1 2 2 0 0 0 0 0 0 0 
0 0 0 0 0 0 0 2 0 0 0 0 0 2 2 0 0 0 0 0 0 2 0 0 0 
0 0 0 2 0 0 0 0 0 0 0 0 0 0 0 0 0 0 0 0 0 0 0 0 0 
0 0 0 0 0 0 0 0 0 2 0 0 0 0 0 0 0 0 0 2 0 0 0 0 0 
2 0 0 0 0 2 0 0 0 0 0 0 0 0 0 0 2 0 0 0 0 0 0 2 2 
2 0 0 0 0 0 0 0 0 0 0 0 2 0 0 0 2 0 0 0 0 0 0 2 2 
SPAWNPOINT 1 1 ROCKET_LAUNCHER  POS 18 24 DIR -1.5707963267948966 W 0 CD 1 BV 4 DIRECTIONS 1 END
 ROCKET_LAUNCHER  POS 2 5 DIR 1.5707963267948966 W 0 CD 0.8 BV 4 DIRECTIONS 1 END
 EXIT 7 13
