25 25
0 0 0 0 0 0 0 0 0 0 0 0 0 0 0 0 0 0 0 0 0 0 0 0 0 
0 0 0 0 0 0 0 0 0 0 0 0 0 0 0 0 0 0 0 0 0 0 0 0 0 
0 0 0 0 0 0 0 0 0 0 0 0 0 0 0 0 0 0 0 0 0 0 0 0 0 
0 0 0 0 0 0 0 0 0 0 0 0 0 0 0 0 0 0 0 0 0 0 0 0 0 
0 0 0 0 0 0 0 0 0 0 0 0 0 0 0 0 0 0 0 0 0 0 0 0 0 
0 0 0 0 0 0 0 0 0 0 0 0 0 0 0 0 0 0 0 0 0 0 0 0 0 
0 0 0 0 0 0 0 0 0 0 0 0 0 0 0 0 0 0 0 0 0 0 0 0 0 
0 0 0 0 0 0 1 1 1 1 1 1 1 1 1 1 1 1 1 1 1 1 1 1 1 
0 0 0 0 0 0 2 2 2 2 2 2 2 2 2 2 2 2 2 2 2 2 2 2 2 
0 0 0 0 0 0 0 0 0 0 0 0 0 0 0 0 0 0 0 0 0 0 0 0 2 
0 0 0 1 2 0 0 0 0 0 0 0 0 0 0 0 0 0 0 0 0 0 0 0 2 
0 0 0 1 2 0 0 2 0 0 0 0 0 0 0 0 0 0 0 0 2 0 0 0 2 
0 0 0 1 2 0 0 0 0 0 0 0 0 0 0 0 0 0 0 0 0 0 0 0 2 
0 0 0 1 2 0 0 0 0 0 0 2 0 0 0 0 0 0 0 0 0 0 0 0 2 
0 0 0 1 2 0 0 0 0 0 0 0 0 0 0 0 0 0 0 0 0 0 0 0 2 
0 0 0 1 2 0 0 0 0 0 0 0 0 0 0 0 0 0 0 0 0 0 0 0 2 
0 0 0 1 2 0 0 0 0 0 0 0 0 0 2 0 0 0 0 0 0 0 0 0 2 
0 0 0 1 2 0 0 0 0 0 0 0 0 0 0 0 0 0 0 0 0 0 0 0 2 
0 0 0 1 2 0 0 0 0 0 0 0 0 0 0 0 0 0 0 0 0 0 0 0 2 
0 0 0 1 2 0 0 0 0 0 0 0 0 0 2 0 0 0 0 0 0 0 0 0 2 
0 0 0 1 2 0 0 0 0 0 0 0 0 0 0 0 0 0 0 0 0 2 0 0 2 
0 0 0 1 2 0 0 0 2 0 0 0 0 0 0 0 0 0 0 0 0 0 0 0 2 
0 0 0 1 2 0 0 0 0 0 0 0 0 0 0 0 0 0 0 0 0 0 0 0 2 
0 0 0 1 2 0 0 0 0 0 0 0 0 0 0 0 0 0 0 0 0 0 0 0 2 
0 0 0 1 2 2 2 2 2 2 2 2 2 2 2 2 2 2 2 2 2 2 2 2 2 
SPAWNPOINT 1 1 ROBOT  POS 9 16 DIR 0 W 3.141592653589793 BV 3 CD 1 MF 30 SHIELDS 2 TEAM a END
 ROBOT  POS 18 15 DIR 0 W -0.3141592653589793 BV 3 CD 1 MF 30 SHIELDS 2 TEAM b END
 ROBOT  POS 11 22 DIR 0 W 3.141592653589793 BV 3 CD 1 MF 30 SHIELDS 2 TEAM c END
 ROBOT  POS 14 10 DIR 0 W 3.141592653589793 BV 3 CD 1 MF 30 SHIELDS 2 TEAM d END
 ROBOT  POS 17 21 DIR 0 W 3.141592653589793 BV 3 CD 1 MF 30 SHIELDS 2 TEAM e END
 ROBOT  POS 6 18 DIR 0 W 3.141592653589793 BV 3 CD 1 MF 30 SHIELDS 2 TEAM f END
 ROBOT  POS 21 14 DIR 0 W 3.141592653589793 BV 3 CD 1 MF 30 SHIELDS 2 TEAM g END
 ROBOT  POS 10 11 DIR 0 W 3.141592653589793 BV 3 CD 1 MF 30 SHIELDS 2 TEAM h END
