50 50
0 0 0 0 0 0 0 0 1 1 a 0 0 0 0 0 0 0 0 0 0 0 0 0 1 1 1 1 1 1 1 1 1 0 0 0 1 0 0 0 0 0 0 0 0 0 0 0 0 0 
0 0 0 0 0 0 0 0 0 0 0 0 0 0 0 0 0 0 0 0 0 0 0 0 1 a 0 0 0 0 0 b 1 0 0 0 1 0 0 0 0 0 0 0 0 0 0 0 0 0 
0 0 0 c 1 d 0 0 0 0 0 0 0 0 0 0 0 0 0 0 0 0 0 0 1 0 0 0 0 0 0 0 1 0 0 0 1 0 0 0 0 0 0 0 0 0 1 d 0 0 
1 1 1 1 1 1 1 1 1 1 1 1 0 1 1 1 0 1 1 0 1 0 0 0 1 0 0 0 0 0 0 0 1 0 0 0 1 0 0 0 0 0 0 0 0 0 1 1 0 0 
1 0 0 0 1 1 1 1 1 1 1 1 0 1 0 1 0 1 1 0 1 0 0 0 1 d 0 0 0 0 0 c 1 0 0 0 1 0 0 0 0 0 0 0 0 0 0 0 0 0 
1 1 1 1 1 a 0 0 0 b 1 1 1 1 0 1 1 1 1 1 a 0 0 0 1 1 1 0 0 0 1 1 1 0 0 0 1 0 0 0 0 0 0 0 0 0 0 0 0 0 
0 0 0 0 0 0 0 0 0 0 0 0 0 0 0 0 0 0 0 0 0 0 0 0 0 0 1 0 0 0 0 0 1 0 0 0 1 0 0 0 1 1 0 0 0 0 0 0 0 0 
0 0 0 0 0 0 0 0 0 0 0 0 0 0 0 0 0 0 0 0 0 0 0 0 0 0 1 0 0 0 1 1 1 0 0 0 1 0 0 0 1 1 0 0 0 0 0 0 0 0 
0 0 0 0 c 1 1 1 1 1 d 0 0 1 0 0 0 1 0 0 1 0 0 0 1 1 a 0 0 0 1 0 0 0 0 0 1 0 0 0 0 0 0 0 0 0 0 1 1 0 
0 0 0 0 1 a 0 0 0 b 1 0 0 1 0 0 0 1 0 0 1 0 0 0 0 0 0 0 0 0 1 1 1 0 0 0 1 0 0 0 0 0 0 0 0 0 0 1 1 0 
0 0 0 0 1 0 0 0 0 0 1 0 c 1 d 0 c 1 d c 1 d 0 0 0 0 0 0 0 c 1 1 1 0 0 0 1 d 0 0 0 0 0 0 0 0 0 0 0 0 
0 0 0 0 1 0 0 0 0 0 1 1 1 1 1 1 1 1 1 1 1 1 1 1 1 1 1 1 1 1 1 1 a 0 0 0 b 1 1 1 1 1 1 1 d 0 0 0 0 0 
0 0 0 0 0 0 0 0 0 0 0 0 0 0 0 0 0 b 1 0 0 0 0 0 0 0 0 0 0 0 0 0 0 0 0 0 0 0 b 1 1 1 1 1 1 0 0 0 0 0 
0 0 0 0 0 0 0 1 1 0 0 0 0 0 0 1 0 0 0 0 0 0 0 0 0 0 0 0 0 0 0 0 0 0 0 0 0 0 0 0 0 b 1 1 1 0 0 0 0 0 
0 0 0 0 0 0 0 1 a 0 0 0 1 0 0 0 0 0 0 0 0 0 0 0 0 0 0 0 0 0 0 0 0 0 0 0 0 0 0 0 0 0 0 0 1 0 0 0 0 0 
1 1 1 1 1 0 0 0 0 0 0 0 1 1 1 1 1 1 1 1 1 1 1 1 1 1 1 1 1 1 1 1 1 1 1 1 1 1 1 1 1 1 1 1 1 d 0 0 0 0 
0 0 0 b 1 0 0 0 0 0 0 0 1 a 0 1 1 a 0 0 0 0 0 b 1 a 0 0 1 a 0 0 0 0 0 0 0 0 0 0 0 b 1 0 0 1 0 0 0 0 
0 0 0 0 1 0 0 0 0 0 0 0 1 0 0 1 1 0 0 0 0 0 0 0 1 0 0 0 0 0 0 0 0 0 0 0 0 0 0 0 0 0 1 1 1 1 0 0 0 0 
0 1 d 0 0 0 0 0 0 0 0 0 1 0 0 b 1 0 0 0 1 d 0 0 1 0 0 0 0 0 0 0 0 0 0 0 0 1 d 0 0 0 1 0 0 0 0 0 0 0 
0 1 1 0 0 0 0 0 0 0 0 0 1 0 0 0 0 0 0 0 1 1 0 0 1 0 0 0 0 0 0 0 0 0 0 0 0 b 1 d 0 c 1 0 0 1 0 0 0 0 
0 0 0 0 0 0 0 0 0 0 0 0 1 0 0 0 0 0 0 0 0 0 0 0 1 0 0 0 0 0 0 0 0 0 0 0 0 0 0 b 1 1 1 0 0 1 0 0 0 0 
0 0 0 0 1 1 1 1 1 1 1 1 a 0 0 0 0 1 d 0 0 0 0 0 1 0 0 0 0 0 0 0 0 0 0 0 0 0 0 0 0 b 1 1 1 1 0 0 0 0 
0 0 0 0 0 0 0 0 0 0 0 0 0 0 0 0 0 b 1 d 0 0 0 c 1 1 1 0 0 0 0 0 0 0 0 0 0 0 0 0 0 0 1 0 0 0 0 0 0 0 
0 0 0 0 0 0 0 0 0 0 0 0 0 0 0 0 0 0 0 1 0 0 0 1 0 b 1 0 0 0 0 0 0 0 0 0 0 0 0 0 0 0 1 1 1 1 0 0 0 0 
0 1 1 0 0 0 0 0 0 0 0 0 0 0 0 0 0 0 0 1 0 0 0 0 0 0 1 0 0 0 0 0 0 0 0 0 0 0 0 0 0 0 1 0 0 1 0 0 0 0 
0 1 1 0 0 0 0 0 0 0 0 0 0 0 0 0 0 0 0 1 0 0 0 0 0 0 1 0 0 0 0 0 0 0 0 0 0 0 0 0 0 0 1 1 1 1 0 0 0 0 
0 0 0 0 0 0 0 0 0 0 0 0 0 0 0 0 0 0 0 1 0 0 0 0 0 0 1 1 0 0 0 0 0 0 0 0 0 0 0 0 0 0 1 0 0 0 0 0 0 0 
0 0 0 0 0 0 0 0 0 1 d 0 0 0 1 1 0 0 0 1 0 0 0 1 0 c 1 1 0 0 0 0 0 0 0 0 0 0 0 0 0 0 1 1 1 1 0 0 0 0 
0 0 0 0 0 0 0 0 0 1 1 0 0 0 1 1 0 1 1 1 d 0 0 1 1 1 1 0 0 0 0 c 1 0 0 0 0 0 0 0 0 0 1 1 1 1 0 0 0 0 
1 1 1 0 0 0 0 0 c 1 1 0 0 0 0 0 0 1 a 0 1 0 0 1 0 b 1 0 0 0 0 1 1 0 0 0 0 0 0 0 0 0 1 0 0 0 0 0 0 0 
1 1 a 0 0 0 0 0 1 1 a 0 0 0 0 0 0 1 0 0 0 0 0 0 0 0 1 0 0 0 0 b 1 0 0 0 0 0 0 0 0 1 1 1 1 1 0 0 0 0 
0 0 0 0 0 0 0 0 1 1 0 0 0 0 0 0 0 1 0 0 0 0 0 0 0 0 1 0 0 0 0 0 1 d 0 0 0 0 0 0 0 1 1 0 0 1 0 0 0 0 
0 0 0 0 0 0 0 0 b 1 0 0 1 0 0 0 0 1 0 0 0 0 0 0 0 0 1 0 0 0 0 c 1 1 1 d 0 0 0 0 0 0 1 1 1 1 0 0 0 0 
1 1 0 0 0 0 0 0 0 0 0 0 1 0 0 0 0 1 d 0 1 0 0 1 0 c 1 0 0 0 1 1 1 1 1 1 1 d 0 0 0 0 1 0 0 0 0 0 0 0 
1 a 0 0 0 0 0 0 0 0 0 0 0 0 c 1 1 1 1 1 a 0 0 b 1 1 1 0 0 0 1 0 0 b 1 1 1 1 1 1 0 0 1 1 1 1 0 0 0 0 
0 0 0 0 0 0 0 0 0 0 0 0 c 1 1 1 a 0 0 0 0 0 0 0 0 0 0 0 0 0 1 0 0 0 0 b 1 1 1 a 0 0 1 0 0 1 0 0 0 0 
0 0 0 0 0 0 0 0 0 0 0 0 1 1 1 a 0 0 0 0 0 0 0 0 0 0 0 0 0 0 1 0 0 0 0 0 0 0 0 0 0 0 1 1 1 a 0 0 0 0 
1 1 1 d 0 0 0 0 0 0 0 c 1 1 1 0 0 0 0 0 0 0 0 0 0 0 0 0 0 0 1 0 0 0 0 0 0 0 0 0 0 0 1 1 a 0 0 0 0 0 
1 1 1 1 1 1 1 1 1 1 1 1 1 1 a 0 0 0 1 1 0 0 0 0 1 1 0 0 0 0 1 0 0 c 1 0 0 0 c 1 1 1 1 1 0 0 0 0 0 0 
0 b 1 1 0 0 0 0 0 0 0 0 0 1 0 0 0 0 1 a 0 0 0 0 1 1 0 0 0 0 1 0 0 1 1 0 0 0 1 1 1 1 1 1 1 d 0 0 0 0 
0 0 b 1 0 1 1 1 1 1 1 1 0 1 0 0 0 0 0 0 0 0 0 0 0 0 0 0 0 1 1 0 0 0 0 0 0 0 1 1 a 0 0 b 1 1 0 0 0 0 
0 0 0 1 0 0 0 0 0 0 0 0 0 1 0 0 0 0 0 0 0 0 0 0 0 0 0 0 0 1 1 d 0 0 0 0 0 0 0 0 0 0 0 0 1 1 0 0 0 0 
0 0 0 0 0 0 0 0 0 0 0 0 0 1 0 0 0 0 0 0 1 1 0 0 0 0 0 0 0 0 1 1 0 0 0 0 0 0 0 0 0 0 0 0 0 0 0 0 0 0 
0 0 0 0 0 0 0 0 0 0 0 0 0 0 0 0 0 0 0 0 1 1 0 0 0 0 0 0 0 0 1 1 0 0 0 0 0 0 0 0 0 0 0 0 0 0 0 0 0 0 
0 0 0 0 0 0 0 0 0 0 0 0 0 1 0 0 0 0 0 0 0 0 0 0 0 0 0 0 0 0 1 1 0 0 0 0 0 0 0 0 0 0 0 0 0 0 0 0 0 0 
0 0 0 1 0 0 0 0 0 0 0 0 0 1 d 0 0 0 0 0 0 0 0 0 0 0 0 0 0 0 1 a 0 0 0 0 0 0 0 0 0 0 0 0 0 0 0 0 0 0 
0 0 0 1 0 1 1 1 1 1 1 1 0 1 1 1 d 0 0 0 0 0 0 0 0 0 0 0 0 0 1 0 0 0 0 0 0 0 0 0 0 0 0 0 0 0 0 0 0 0 
0 0 0 1 0 0 0 0 0 0 0 0 0 1 1 1 1 0 0 0 0 0 0 0 0 0 1 d 0 0 1 d 0 0 0 0 c 1 1 1 0 0 0 0 0 0 0 0 0 0 
0 0 0 1 1 1 1 1 1 1 1 1 1 1 1 a 0 0 0 0 0 0 0 0 0 0 1 1 0 0 1 1 1 0 0 0 1 1 a 0 0 0 0 0 0 0 0 0 0 0 
0 0 c 1 0 0 0 0 0 0 0 0 0 1 1 0 0 0 0 0 c 1 1 0 0 c 1 1 d 0 1 1 1 d 0 0 0 0 0 0 0 0 0 0 0 0 0 0 0 0 
SPAWNPOINT 1 1 TURRET  POS 7 10 DIR 0 W 3.141592653589793 CD 1 BV 8 END
 TURRET  POS 9 17 DIR 0 W -3.4871678454846706 CD 1 BV 8 END
 TURRET  POS 5 19 DIR 1.8849555921538759 W 3.4871678454846706 CD 1 BV 8 END
 TURRET  POS 8 24 DIR 3.141592653589793 W 3.141592653589793 CD 1 BV 8 END
 TURRET  POS 13 30 DIR 3.141592653589793 W 3.141592653589793 CD 1 BV 8 END
 TURRET  POS 4 32 DIR 3.141592653589793 W 3.141592653589793 CD 1 BV 8 END
 TURRET  POS 5 28 DIR 3.141592653589793 W 3.141592653589793 CD 1 BV 8 END
 TURRET  POS 9 36 DIR 3.141592653589793 W 3.141592653589793 CD 1 BV 8 END
 TURRET  POS 14 24 DIR 3.141592653589793 W 3.141592653589793 CD 1 BV 8 END
 TURRET  POS 5 35 DIR 3.141592653589793 W 3.141592653589793 CD 1 BV 8 END
 TURRET  POS 19 31 DIR 3.141592653589793 W 0.3141592653589793 CD 1 BV 30 END
 TURRET  POS 24 31 DIR 3.141592653589793 W -0.3141592653589793 CD 1 BV 30 END
 TURRET  POS 24 25 DIR 1.5707963267948966 W -0.3141592653589793 CD 1 BV 30 END
 TURRET  POS 22 39 DIR 1.5707963267948966 W 15.707963267948966 CD 0.2 BV 4 END
 TURRET  POS 16 38 DIR 1.5707963267948966 W 15.707963267948966 CD 0.2 BV 4 END
 TURRET  POS 27 38 DIR 1.5707963267948966 W 15.707963267948966 CD 0.2 BV 4 END
 TURRET  POS 25 42 DIR 1.5707963267948966 W 15.707963267948966 CD 0.2 BV 4 END
 TURRET  POS 17 42 DIR 1.5707963267948966 W 15.707963267948966 CD 0.2 BV 4 END
 TURRET  POS 21 46 DIR 1.5707963267948966 W 15.707963267948966 CD 0.2 BV 4 END
 TURRET  POS 46 44 DIR 0 W 0.3141592653589793 CD 0.2 BV 4 END
 TURRET  POS 43 47 DIR 0 W 0.3141592653589793 CD 0.2 BV 4 END
 TURRET  POS 44 3 DIR 0 W 3.141592653589793 CD 1 BV 8 END
 TURRET  POS 38 9 DIR 0 W -3.141592653589793 CD 1 BV 8 END
 TURRET  POS 45 6 DIR 0 W -3.141592653589793 CD 1 BV 8 END
 ROCKET_LAUNCHER  POS 12 4 DIR -1.5707963267948966 W 0 CD 1 BV 5 DIRECTIONS 1 END
 ROCKET_LAUNCHER  POS 16 4 DIR -1.5707963267948966 W 0 CD 0.9 BV 5 DIRECTIONS 1 END
 ROCKET_LAUNCHER  POS 19 4 DIR -1.5707963267948966 W 0 CD 0.8 BV 5 DIRECTIONS 1 END
 ROCKET_LAUNCHER  POS 31 6 DIR 3.141592653589793 W 0 CD 1 BV 3 DIRECTIONS 1 END
 ROCKET_LAUNCHER  POS 37 12 DIR 3.141592653589793 W 0 CD 3 BV 2 DIRECTIONS 1 END
 ROCKET_LAUNCHER  POS 40 13 DIR 3.141592653589793 W 0 CD 3 BV 2 DIRECTIONS 1 END
 ROCKET_LAUNCHER  POS 43 14 DIR 3.141592653589793 W 0 CD 3 BV 2 DIRECTIONS 1 END
 ROCKET_LAUNCHER  POS 38 44 DIR 0 W 0.3141592653589793 CD 1.1 BV 4 DIRECTIONS 4 END
 ROCKET_LAUNCHER  POS 43 33 DIR 0 W 0 CD 1 BV 4 DIRECTIONS 1 END
 ROCKET_LAUNCHER  POS 43 29 DIR 0 W 0 CD 1 BV 3 DIRECTIONS 1 END
 ROCKET_LAUNCHER  POS 43 22 DIR 0 W 0 CD 2 BV 1 DIRECTIONS 1 END
 ROCKET_LAUNCHER  POS 43 18 DIR 0 W 0 CD 1 BV 5 DIRECTIONS 1 END
 LASER_CARRIER  POS 25 6 DIR -1.5707963267948966 W -0.1 DIRECTIONS 5 END
 LASER_CARRIER  POS 31 8 DIR 3.141592653589793 W 0.6283185307179586 DIRECTIONS 3 END
 LASER_CARRIER  POS 4 44 DIR 0 W 0 DIRECTIONS 1 END
 LASER_CARRIER  POS 4 42 DIR 0 W 0 DIRECTIONS 1 END
 LASER_CARRIER  POS 34 22 DIR 0 W 0.15707963267948966 DIRECTIONS 6 END
 LASER_CARRIER  POS 43 26 DIR 0 W 0.3141592653589793 DIRECTIONS 3 END
 EXIT 39 2
 BONUS POS 28 2 TYPE shield END
 BONUS POS 34 1 TYPE shield END
 BONUS POS 34 2 TYPE shield END
 BONUS POS 1 47 TYPE shield END
 BONUS POS 40 17 TYPE shield END