50 50
0 0 0 0 0 0 1 1 1 1 1 1 1 1 0 0 0 0 0 0 0 0 0 0 0 0 0 1 0 0 0 0 0 0 1 0 0 0 1 1 0 0 0 0 0 0 0 0 0 0 
0 0 0 0 0 0 1 1 1 1 1 1 1 1 0 0 0 0 0 1 0 0 0 0 0 0 0 1 0 0 0 0 0 0 1 0 0 0 0 0 0 0 0 0 0 0 0 0 0 0 
0 0 0 0 0 0 1 1 1 1 1 1 1 1 0 0 0 0 0 0 0 0 1 1 1 0 0 1 0 0 1 1 1 1 1 0 0 0 0 0 0 0 0 0 0 1 0 0 0 0 
0 0 0 0 0 0 0 0 0 0 0 0 0 1 0 0 0 0 0 1 0 0 0 0 0 0 0 1 0 0 0 0 0 0 1 0 0 0 0 0 0 0 0 0 0 1 1 1 0 0 
0 0 0 0 0 0 0 0 0 0 0 0 0 1 0 0 0 0 0 0 0 0 0 0 0 0 0 1 0 0 0 0 0 0 1 0 0 0 0 0 0 0 0 0 0 0 0 0 0 0 
0 0 0 0 0 0 0 0 0 0 0 0 0 1 1 1 1 1 1 1 1 1 1 1 1 0 0 1 0 0 0 0 0 0 1 0 0 0 0 0 0 0 0 0 0 0 0 0 0 0 
1 1 1 1 1 1 1 1 1 1 0 0 0 0 0 0 0 0 0 0 0 0 0 0 1 0 0 1 1 1 1 0 0 0 1 0 0 0 1 1 0 0 0 0 0 0 0 0 0 0 
1 1 0 0 0 0 0 0 0 1 0 0 0 0 0 0 0 0 0 0 0 0 0 0 1 0 0 0 0 0 1 0 0 0 1 0 0 0 1 1 0 0 0 0 0 1 1 0 0 0 
1 1 0 0 0 0 0 0 0 1 0 0 0 0 0 0 1 1 0 0 1 1 0 0 1 0 0 0 0 0 1 0 0 0 1 1 0 0 0 0 0 0 0 0 0 1 1 0 0 0 
1 1 0 0 0 0 0 0 0 1 1 1 1 1 0 0 1 1 0 0 1 1 0 0 1 0 0 1 1 1 1 0 0 0 0 1 0 0 0 0 0 0 0 0 0 0 0 0 0 0 
1 1 0 0 0 1 0 0 0 0 0 0 0 0 0 0 0 0 0 0 0 0 0 0 1 0 0 1 0 0 0 0 0 0 0 1 0 0 0 0 0 0 0 0 0 0 0 0 0 0 
1 1 0 0 1 1 1 0 0 0 0 0 0 0 0 0 0 0 0 0 0 0 0 0 1 0 0 1 0 0 0 0 0 0 1 1 0 0 0 0 0 0 0 0 0 0 0 0 0 0 
1 1 0 0 0 1 0 0 0 0 0 0 0 0 0 0 0 0 0 0 0 0 0 0 1 0 0 1 1 1 1 0 0 0 1 0 0 0 0 0 1 1 1 0 0 0 0 1 0 0 
1 1 0 0 0 0 0 0 0 1 1 1 1 1 0 0 1 1 0 0 1 1 0 0 1 0 0 0 0 0 1 0 0 0 1 1 0 0 0 0 1 0 0 0 0 0 0 1 0 0 
1 1 0 0 0 0 0 0 0 0 0 0 0 1 0 0 1 1 0 0 1 1 0 0 1 0 0 0 0 0 1 0 0 0 0 1 1 1 0 0 0 0 0 0 0 0 0 0 0 0 
1 1 0 0 0 0 0 0 0 0 0 0 0 1 0 0 0 0 0 0 0 0 0 0 1 0 0 1 1 1 1 1 1 0 0 0 0 1 0 0 0 0 0 0 0 0 0 0 0 0 
1 1 1 1 1 1 1 1 1 1 0 0 0 1 0 0 0 0 0 0 0 0 0 0 1 0 0 0 0 0 0 0 1 0 0 0 0 1 0 0 0 1 1 1 1 1 1 1 1 1 
1 0 0 0 0 0 0 0 0 0 0 0 0 1 1 1 1 1 1 1 1 1 1 1 1 0 0 0 0 0 0 0 1 1 1 0 0 1 1 0 0 1 1 1 1 1 1 1 1 1 
1 0 0 0 0 0 0 0 0 0 0 0 0 1 0 0 0 0 0 0 0 0 0 0 0 0 0 1 1 1 0 0 1 1 1 0 0 1 1 0 0 1 1 0 0 1 1 1 1 1 
1 0 0 0 0 0 0 0 0 0 0 0 0 1 0 0 0 0 0 0 0 0 0 0 0 0 0 1 0 0 0 0 1 0 0 0 0 0 0 0 0 0 0 0 0 0 0 0 0 1 
1 0 0 0 1 1 1 1 1 1 1 1 1 1 0 0 0 0 0 0 0 0 0 0 0 0 0 1 0 0 0 0 1 0 0 0 0 0 0 0 0 0 0 0 0 0 0 0 0 0 
1 0 0 0 0 0 0 0 0 0 0 0 0 0 0 0 0 1 1 0 0 0 1 1 0 0 0 1 0 0 0 0 1 1 1 0 0 1 1 0 0 1 1 0 0 1 1 0 0 1 
1 0 0 0 0 0 0 0 0 0 0 0 0 0 0 0 0 1 1 0 0 0 1 1 0 0 0 1 0 0 0 0 1 1 1 0 0 1 1 0 0 1 1 0 0 1 1 0 0 1 
1 0 0 0 0 0 0 0 0 0 0 0 0 0 0 0 0 0 0 0 0 0 0 0 0 0 0 1 0 0 0 0 1 0 0 0 0 0 0 0 0 0 0 0 0 0 0 0 0 0 
1 0 0 0 1 1 1 1 1 1 1 1 1 1 0 0 0 0 0 0 0 0 0 0 0 0 0 1 0 0 0 0 1 0 0 0 0 0 0 0 0 0 0 0 0 0 0 0 0 0 
1 0 0 0 0 0 0 0 0 0 0 0 0 1 0 0 0 0 0 0 0 0 0 0 0 0 0 1 0 0 0 0 1 1 1 0 0 1 1 0 0 1 1 0 0 1 1 0 0 1 
1 0 0 0 0 0 0 0 0 0 0 0 0 1 0 0 0 1 1 0 0 0 1 1 0 0 0 1 0 0 0 0 1 1 1 0 0 1 1 0 0 1 1 0 0 1 1 0 0 1 
1 0 0 0 0 0 0 0 0 0 0 0 0 1 0 0 0 1 1 0 0 0 1 1 0 0 0 1 0 0 0 0 1 0 0 0 0 0 0 0 0 0 0 0 0 0 0 0 0 0 
1 1 1 1 1 1 1 1 1 1 1 1 1 1 0 0 0 0 0 0 0 0 0 0 0 0 0 1 0 0 0 0 1 0 0 0 0 0 0 0 0 0 0 0 0 0 0 0 0 0 
0 0 0 0 0 0 0 0 0 0 0 0 0 1 0 0 0 0 0 0 0 0 0 0 0 0 0 1 0 0 0 0 1 1 1 0 0 1 1 0 0 1 1 0 0 1 1 0 0 1 
0 0 0 0 0 0 0 0 0 0 0 0 0 1 0 0 0 0 0 0 0 0 0 0 0 0 0 1 0 0 0 0 1 1 1 0 0 1 1 0 0 1 1 0 0 1 1 0 0 1 
0 0 0 0 0 0 0 0 0 0 0 0 0 1 1 0 0 1 1 1 1 1 1 1 1 1 1 1 0 0 0 0 1 0 0 0 0 0 0 0 0 0 0 0 0 0 0 0 0 0 
0 0 0 0 0 0 0 0 1 0 0 0 0 1 0 0 0 0 1 0 0 0 0 0 0 0 0 0 0 0 0 0 1 1 1 0 0 0 0 0 0 0 0 0 0 0 0 0 0 0 
0 0 0 0 0 0 0 0 1 0 0 0 0 1 0 0 0 0 1 0 0 0 1 1 1 1 1 1 1 1 1 1 1 1 1 1 1 1 1 0 0 1 1 0 0 1 1 0 0 1 
0 0 0 0 0 0 0 0 1 0 1 1 0 1 0 1 1 0 1 0 0 0 1 0 0 0 0 0 0 0 0 0 0 0 0 0 0 1 1 0 0 1 1 0 0 1 1 0 0 1 
0 0 0 0 0 0 0 0 1 0 1 1 0 1 0 1 1 0 1 0 0 0 1 0 0 0 0 0 0 0 0 0 0 0 0 0 0 1 1 1 1 1 1 1 1 1 0 0 0 1 
0 0 0 0 0 0 0 0 1 0 0 0 0 1 0 0 0 0 1 0 0 0 1 0 0 0 0 1 0 0 0 0 0 0 0 0 0 1 0 0 0 0 0 1 0 0 0 0 0 0 
0 0 0 0 0 0 0 0 1 0 0 0 0 0 0 0 0 0 1 0 0 0 1 0 0 0 1 1 1 0 0 0 1 1 1 0 0 1 0 0 0 0 0 1 0 0 0 0 0 0 
0 0 0 0 0 0 0 0 1 0 1 1 0 0 0 1 1 0 1 0 0 0 1 0 0 0 0 0 0 0 0 0 0 1 0 0 0 1 0 0 0 0 0 1 0 0 0 0 0 0 
0 0 0 0 0 0 0 0 1 0 1 1 0 0 0 1 1 0 1 0 0 0 0 0 0 0 0 0 0 0 0 0 0 0 0 0 0 1 0 0 0 0 0 0 0 0 0 0 0 0 
0 0 0 0 0 0 0 0 1 0 0 0 0 0 0 0 0 0 1 0 0 0 0 0 0 0 0 0 0 0 0 0 0 0 0 0 0 0 0 0 0 0 0 0 0 0 0 0 0 0 
1 1 0 0 0 0 1 1 1 1 1 1 1 1 1 1 1 1 1 1 1 1 1 1 0 0 1 1 0 0 0 0 0 0 1 1 0 0 0 0 1 1 1 1 1 1 1 0 0 0 
0 0 0 0 0 0 0 0 0 0 0 0 0 0 0 0 0 0 0 0 0 0 0 0 0 0 1 1 0 0 0 0 0 0 1 0 0 0 0 0 0 0 0 0 1 0 0 0 0 0 
0 0 0 0 0 0 0 0 0 0 0 0 0 0 0 0 0 0 0 0 0 0 0 0 0 0 1 0 0 0 1 1 0 0 1 0 0 1 0 0 0 0 0 0 1 0 0 0 0 0 
0 0 0 0 0 0 0 0 0 0 0 0 0 0 0 0 0 0 0 0 0 0 0 0 0 0 1 0 0 0 1 1 0 0 1 0 0 1 0 1 1 1 0 0 0 0 0 1 1 1 
0 0 0 0 0 1 1 0 0 0 0 0 0 0 0 0 0 0 0 0 0 0 0 0 0 0 1 0 0 0 0 0 0 0 0 0 0 1 0 0 0 0 0 0 0 0 0 0 0 0 
0 0 0 0 0 1 1 0 0 0 0 0 0 0 0 0 0 0 0 0 0 0 0 0 0 0 1 1 1 1 0 0 0 0 0 0 1 1 0 0 0 0 0 0 0 0 0 0 0 0 
0 0 0 0 0 0 0 0 0 0 0 0 0 0 0 0 0 0 0 0 0 0 0 0 0 0 1 0 0 1 0 0 1 0 0 0 0 0 0 0 0 0 0 1 0 0 0 0 0 0 
0 0 0 0 0 0 0 0 0 0 0 0 0 0 0 0 0 0 0 0 0 0 0 0 0 0 1 0 0 1 0 0 1 0 0 0 0 0 0 0 0 0 0 1 0 0 0 0 0 0 
0 0 0 0 0 0 0 0 0 0 0 0 0 0 0 0 0 0 0 0 0 0 0 0 0 0 1 0 0 0 0 0 1 0 0 1 1 1 1 1 1 0 0 1 0 0 0 0 0 0 
SPAWNPOINT 1 1 
TURRET  POS 5 14 DIR 0 W 3.141592653589793 CD 1 BV 10 END
 TURRET  POS 5 8 DIR 3.141592653589793 W 3.141592653589793 CD 1 BV 10 END
 TURRET  POS 2 26 DIR 3.141592653589793 W 3.141592653589793 CD 1 BV 10 END
 TURRET  POS 5 26 DIR 3.141592653589793 W 3.141592653589793 CD 1 BV 10 END
 TURRET  POS 8 26 DIR 3.141592653589793 W 3.141592653589793 CD 1 BV 10 END
 TURRET  POS 29 14 DIR 3.141592653589793 W 15.707963267948966 CD 0.3 BV 5 END
 TURRET  POS 21 4 DIR 3.141592653589793 W 15.707963267948966 CD 0.3 BV 5 END
 TURRET  POS 16 0 DIR 3.141592653589793 W 15.707963267948966 CD 0.3 BV 5 END
 TURRET  POS 28 7 DIR 3.141592653589793 W 15.707963267948966 CD 0.3 BV 5 END
 TURRET  POS 29 10 DIR 3.141592653589793 W 15.707963267948966 CD 0.3 BV 5 END
 TURRET  POS 18 12 DIR 3.141592653589793 W 15.707963267948966 CD 0.3 BV 5 END
 TURRET  POS 15 7 DIR 3.141592653589793 W 15.707963267948966 CD 0.3 BV 5 END
 TURRET  POS 22 10 DIR 3.141592653589793 W 15.707963267948966 CD 0.3 BV 5 END
 TURRET  POS 15 31 DIR 3.141592653589793 W 15.707963267948966 CD 0.3 BV 5 END
 TURRET  POS 24 24 DIR 3.141592653589793 W 15.707963267948966 CD 0.3 BV 5 END
 TURRET  POS 16 19 DIR 3.141592653589793 W 15.707963267948966 CD 0.3 BV 5 END
 TURRET  POS 13 39 DIR 3.141592653589793 W 15.707963267948966 CD 0.3 BV 5 END
 TURRET  POS 22 32 DIR 3.141592653589793 W 0.9424777960769379 CD 1 BV 30 END
 TURRET  POS 29 26 DIR 3.141592653589793 W 15.707963267948966 CD 0.1 BV 5 END
 TURRET  POS 30 23 DIR 3.141592653589793 W 15.707963267948966 CD 0.1 BV 5 END
 TURRET  POS 31 28 DIR 3.141592653589793 W 15.707963267948966 CD 0.1 BV 5 END
 TURRET  POS 29 30 DIR 3.141592653589793 W 15.707963267948966 CD 0.1 BV 5 END
 TURRET  POS 28 21 DIR 3.141592653589793 W 15.707963267948966 CD 0.1 BV 5 END
 TURRET  POS 31 20 DIR 3.141592653589793 W 15.707963267948966 CD 0.1 BV 5 END
 TURRET  POS 19 34 DIR 3.141592653589793 W 15.707963267948966 CD 0.1 BV 5 END
 TURRET  POS 21 37 DIR 3.141592653589793 W 15.707963267948966 CD 0.1 BV 5 END
 TURRET  POS 1 46 DIR 0 W 0.9424777960769379 CD 0.4 BV 5 END
 TURRET  POS 4 37 DIR 0 W 0.9424777960769379 CD 0.4 BV 5 END
 TURRET  POS 2 32 DIR 0 W 0.9424777960769379 CD 0.4 BV 5 END
 TURRET  POS 11 15 DIR 0 W 3.141592653589793 CD 1 BV 10 END
 TURRET  POS 36 31 DIR 1.2566370614359172 W 0.9424777960769379 CD 1 BV 30 END
 TURRET  POS 40 20 DIR 3.141592653589793 W 0.9424777960769379 CD 1 BV 30 END
 TURRET  POS 49 28 DIR 3.141592653589793 W 0.9424777960769379 CD 1 BV 30 END
 TURRET  POS 34 24 DIR 3.141592653589793 W 0.9424777960769379 CD 1 BV 30 END
 TURRET  POS 44 33 DIR 0.3141592653589793 W -0.9424777960769379 CD 1 BV 30 END
 TURRET  POS 44 5 DIR 0.3141592653589793 W -0.9424777960769379 CD 1 BV 30 END
 TURRET  POS 48 10 DIR 2.827433388230814 W -0.9424777960769379 CD 1 BV 30 END
 TURRET  POS 36 2 DIR 5.026548245743669 W 0.9424777960769379 CD 1 BV 30 END
 TURRET  POS 38 10 DIR 0 W 15.707963267948966 CD 0.3 BV 5 END
 TURRET  POS 44 13 DIR 0 W 15.707963267948966 CD 0.3 BV 5 END
 TURRET  POS 41 3 DIR 0 W 15.707963267948966 CD 0.3 BV 5 END
 TURRET  POS 42 8 DIR 0 W 15.707963267948966 CD 0.3 BV 5 END
 TURRET  POS 48 6 DIR 0 W 15.707963267948966 CD 0.3 BV 5 END
 TURRET  POS 36 6 DIR 0 W 15.707963267948966 CD 0.3 BV 5 END
 TURRET  POS 43 1 DIR 0 W 15.707963267948966 CD 0.3 BV 5 END
 TURRET  POS 44 10 DIR 0 W 15.707963267948966 CD 0.3 BV 5 END
 TURRET  POS 32 4 DIR 0 W 15.707963267948966 CD 0.3 BV 5 END
 TURRET  POS 29 4 DIR 0 W 15.707963267948966 CD 0.3 BV 5 END
 TURRET  POS 32 10 DIR 0 W 15.707963267948966 CD 0.3 BV 5 END
 TURRET  POS 46 47 DIR 3.141592653589793 W 3.141592653589793 CD 1 BV 10 END
 TURRET  POS 31 40 DIR 3.141592653589793 W 3.141592653589793 CD 1 BV 10 END
 TURRET  POS 48 40 DIR 3.141592653589793 W 3.141592653589793 CD 1 BV 10 END
 TURRET  POS 40 38 DIR 3.141592653589793 W 3.141592653589793 CD 1 BV 10 END
 TURRET  POS 33 46 DIR 3.141592653589793 W 3.141592653589793 CD 1 BV 10 END
 TURRET  POS 30 35 DIR 3.141592653589793 W 3.141592653589793 CD 1 BV 10 END
 TURRET  POS 40 46 DIR 0 W 15.707963267948966 CD 0.1 BV 5 END
 TURRET  POS 34 35 DIR 0 W 15.707963267948966 CD 0.1 BV 5 END
 TURRET  POS 28 44 DIR 0 W 15.707963267948966 CD 0.1 BV 5 END
 TURRET  POS 37 41 DIR 0 W 15.707963267948966 CD 0.1 BV 5 END
 LASER_CARRIER  POS 20 24 DIR 3.141592653589793 W 0.141592653589793 CD 0.5 BV 5 DIRECTIONS 5 END
 ROCKET_LAUNCHER  POS 10 45 DIR 3.141592653589793 W 15.707963267948966 CD 0.3 BV 5 DIRECTIONS 1 END
 ROCKET_LAUNCHER  POS 16 47 DIR 3.141592653589793 W 3.141592653589793 CD 0.3 BV 5 DIRECTIONS 1 END
 ROCKET_LAUNCHER  POS 22 45 DIR 0 W 0.9424777960769379 CD 0.4 BV 5 DIRECTIONS 1 END
 ROCKET_LAUNCHER  POS 42 6 DIR 0 W 3.455751918948773 CD 0.5 BV 5 DIRECTIONS 3 END
 EXIT 48 1
 BONUS POS 11 26 TYPE shield END
 BONUS POS 16 2 TYPE shield END
 BONUS POS 32 0 TYPE shield END
 BONUS POS 27 47 TYPE shield END
 BONUS POS 15 3 TYPE shield END