50 50
0 0 0 0 1 0 0 0 1 1 a 0 0 0 0 0 0 0 0 0 0 0 0 0 1 1 1 1 1 1 1 1 1 0 0 0 1 0 0 0 0 0 0 0 0 0 0 0 0 0 
0 0 0 0 0 0 0 0 0 0 0 0 0 0 0 0 0 0 0 0 0 0 0 0 1 a 0 0 0 0 0 b 1 0 0 0 1 0 0 0 0 0 0 0 0 0 0 0 0 0 
0 0 0 c 1 d 0 0 0 0 0 0 0 0 0 0 0 0 0 0 0 0 0 0 1 0 0 0 0 0 0 0 1 0 0 0 1 0 0 0 0 0 0 0 0 0 1 d 0 0 
0 c 1 1 1 1 1 1 1 1 1 1 0 1 1 1 0 1 1 0 1 0 0 0 1 0 0 0 0 0 0 0 1 0 0 0 1 0 0 0 0 0 0 0 0 0 1 1 0 0 
1 1 1 1 1 1 a 0 b 1 1 1 0 1 0 1 0 1 1 0 1 0 0 0 1 d 0 0 0 0 0 c 1 0 0 0 1 0 0 0 0 0 0 0 0 0 0 0 0 0 
0 b 1 1 a 0 0 0 0 0 b 1 1 1 0 1 1 1 1 1 a 0 0 0 1 1 1 0 0 0 1 1 1 0 0 0 1 0 0 0 0 0 0 0 0 0 0 0 0 0 
0 0 0 0 0 0 0 0 0 0 0 0 0 0 0 0 0 0 0 0 0 0 0 0 0 0 1 0 0 0 0 0 1 0 0 0 1 0 0 0 1 1 0 0 0 0 0 0 0 0 
0 0 0 0 0 0 0 0 0 0 0 0 0 0 0 0 0 0 0 0 0 0 0 0 0 c 1 0 0 0 1 1 1 0 0 0 1 0 0 0 1 1 0 0 0 0 0 0 0 0 
0 0 0 0 c 1 1 1 1 1 d 0 0 1 0 0 0 1 0 0 1 0 0 0 1 1 a 0 0 0 1 0 0 0 0 0 1 0 0 0 0 0 0 0 0 0 0 1 1 0 
0 0 0 0 1 a 0 0 0 b 1 0 0 1 0 0 0 1 0 0 1 0 0 0 0 0 0 0 0 0 1 1 1 0 0 0 1 0 0 0 0 0 0 0 0 0 0 1 1 0 
0 0 0 0 1 0 0 0 0 0 1 0 c 1 d 0 c 1 d c 1 d 0 0 0 0 0 0 0 c 1 1 1 0 0 0 1 d 0 0 0 0 0 0 0 0 0 0 0 0 
0 0 0 0 1 0 0 0 0 0 b 1 1 1 1 1 1 1 1 1 1 1 1 1 1 1 1 1 1 1 1 1 a 0 0 0 b 1 1 1 1 1 1 1 d 0 0 0 0 0 
0 0 0 0 0 0 0 0 0 0 0 0 0 0 0 0 0 b 1 0 0 0 0 0 0 0 0 0 0 0 0 0 0 0 0 0 0 0 b 1 1 1 1 1 1 0 0 0 0 0 
0 0 0 0 0 0 0 1 1 0 0 0 0 0 0 1 0 0 0 0 0 0 0 0 0 0 0 0 0 0 0 0 0 0 0 0 0 0 0 0 0 b 1 1 1 0 0 0 0 0 
0 0 0 0 0 0 0 1 a 0 0 0 1 0 0 0 0 0 0 0 0 0 0 0 0 0 0 0 0 0 0 0 0 0 0 0 0 0 0 0 0 0 0 0 1 0 0 0 0 0 
1 1 1 1 1 0 0 0 0 0 0 0 1 1 1 1 1 1 1 1 1 1 1 1 1 1 1 1 1 1 1 1 1 1 1 1 1 1 1 1 1 1 1 1 1 d 0 0 0 0 
0 0 0 b 1 0 0 0 0 0 0 0 1 a 0 1 1 a 0 0 0 0 0 b 1 a 0 0 1 a 0 0 0 0 0 0 0 0 0 0 0 b 1 0 0 1 0 0 0 0 
0 0 0 0 1 0 0 0 0 0 0 0 1 0 0 1 1 0 0 0 0 0 0 0 1 0 0 0 0 0 0 0 0 0 0 0 0 0 0 0 0 0 1 1 1 1 0 0 0 0 
0 1 d 0 0 0 0 0 0 0 0 0 1 0 0 b 1 0 0 0 1 d 0 0 1 0 0 0 0 0 0 0 0 0 0 0 0 1 d 0 0 0 1 0 0 0 0 0 0 0 
0 1 1 0 0 0 0 0 0 0 0 0 1 0 0 0 0 0 0 0 1 1 0 0 1 0 0 0 0 0 0 0 0 0 0 0 0 b 1 d 0 c 1 0 0 1 0 0 0 0 
0 0 0 0 0 0 0 0 0 0 0 c 1 0 0 0 0 0 0 0 0 0 0 0 1 d 0 0 0 0 0 0 0 0 0 0 0 0 0 b 1 1 1 0 0 1 0 0 0 0 
0 0 0 0 1 1 1 1 1 1 1 1 a 0 0 0 0 1 d 0 0 0 0 0 1 1 0 0 0 0 0 0 0 0 0 0 0 0 0 0 0 b 1 1 1 1 0 0 0 0 
0 0 0 0 0 0 0 0 0 0 0 0 0 0 0 0 0 b 1 d 0 0 0 c 1 1 d 0 0 0 0 0 0 0 0 0 0 0 0 0 0 0 1 0 0 0 0 0 0 0 
0 0 0 0 0 0 0 0 0 0 0 0 0 0 0 0 0 0 1 1 0 0 0 1 0 b 1 0 0 0 0 0 0 0 0 0 0 0 0 0 0 0 1 1 1 1 0 0 0 0 
0 1 1 0 0 0 0 0 0 0 0 0 0 0 0 0 0 0 b 1 d 0 0 0 0 0 1 0 0 0 0 0 0 0 0 0 0 0 0 0 0 0 1 0 0 1 0 0 0 0 
0 1 1 0 0 0 0 0 0 0 0 0 0 0 0 0 0 0 0 1 1 0 0 0 0 0 1 0 0 0 0 0 0 0 0 0 0 0 0 0 0 0 1 1 1 1 0 0 0 0 
0 0 0 0 0 0 0 0 0 0 0 0 0 0 0 0 0 0 c 1 a 0 0 0 0 0 1 1 0 0 0 0 0 0 0 0 0 0 0 0 0 0 1 0 0 0 0 0 0 0 
0 0 0 0 0 0 0 0 0 1 d 0 0 0 1 1 0 0 1 1 0 0 0 1 0 c 1 1 0 0 0 0 0 0 0 0 0 0 0 0 0 0 1 1 1 1 0 0 0 0 
0 0 0 0 0 0 0 0 0 1 1 0 0 0 1 1 0 c 1 1 d 0 0 1 1 1 1 0 0 0 0 c 1 0 0 0 0 0 0 0 0 0 1 1 1 1 0 0 0 0 
1 1 1 0 0 0 0 0 c 1 1 0 0 0 0 0 0 1 a 0 1 0 0 1 0 b 1 0 0 0 0 1 1 0 0 0 0 0 0 0 0 0 1 0 0 0 0 0 0 0 
1 1 a 0 0 0 0 0 1 1 a 0 0 0 0 0 0 1 0 0 0 0 0 0 0 0 1 0 0 0 0 b 1 0 0 0 0 0 0 0 0 1 1 1 1 1 0 0 0 0 
0 0 0 0 0 0 0 0 1 1 0 0 0 0 0 0 0 1 0 0 0 0 0 0 0 0 1 0 0 0 0 0 1 d 0 0 0 0 0 0 0 1 1 0 0 1 0 0 0 0 
0 0 0 0 0 0 0 0 b 1 0 0 1 0 0 0 0 1 0 0 0 0 0 0 0 0 1 0 0 0 0 c 1 1 1 d 0 0 0 0 0 0 1 1 1 1 0 0 0 0 
1 1 0 0 0 0 0 0 0 0 0 0 1 0 0 0 c 1 d 0 1 0 0 1 0 c 1 0 0 0 c 1 1 1 1 1 1 d 0 0 0 0 1 0 0 0 0 0 0 0 
1 a 0 0 0 0 0 0 0 0 0 0 0 0 c 1 1 1 1 1 a 0 0 b 1 1 1 0 0 0 1 a 0 b 1 1 1 1 1 1 0 0 1 1 1 1 0 0 0 0 
0 0 0 0 0 0 0 0 0 0 0 0 c 1 1 1 a 0 0 0 0 0 0 0 0 0 0 0 0 0 1 0 0 0 0 b 1 1 1 a 0 0 1 0 0 1 0 0 0 0 
0 0 0 0 0 0 0 0 0 0 0 0 1 1 1 a 0 0 0 0 0 0 0 0 0 0 0 0 0 0 b d 0 0 0 0 0 0 0 0 0 0 1 1 1 a 0 0 0 0 
1 1 1 d 0 0 0 0 0 0 0 c 1 1 1 0 0 0 0 0 0 0 0 0 0 0 0 0 0 0 0 1 0 0 0 0 0 0 0 0 0 0 1 1 a 0 0 0 0 0 
1 1 1 1 1 1 1 1 1 1 1 1 1 1 a 0 0 0 1 1 0 0 0 0 1 1 0 0 0 0 c a 0 c 1 0 0 0 c 1 1 1 1 1 0 0 0 0 0 0 
0 b 1 1 0 0 0 0 0 0 0 0 0 1 0 0 0 0 1 a 0 0 0 0 1 1 0 0 0 0 1 0 0 1 1 0 0 0 1 1 1 1 1 1 1 d 0 0 0 0 
0 0 b 1 0 1 1 1 1 1 1 1 0 1 0 0 0 0 0 0 0 0 0 0 0 0 0 0 0 0 1 0 0 0 0 0 0 0 1 1 a 0 0 b 1 1 0 0 0 0 
0 0 0 1 0 0 0 0 0 0 0 0 0 1 0 0 0 0 0 0 0 0 0 0 0 0 0 0 0 c 1 d 0 0 0 0 0 0 0 0 0 0 0 0 1 1 0 0 0 0 
0 0 0 0 0 0 0 0 0 0 0 0 0 1 0 0 0 0 0 0 1 1 0 0 0 0 0 0 0 1 1 1 0 0 0 0 0 0 0 0 0 0 0 0 0 0 0 0 0 0 
0 0 0 0 0 0 0 0 0 0 0 0 0 0 0 0 0 0 0 0 1 1 0 0 0 0 0 0 0 1 1 1 0 0 0 0 0 0 0 0 0 0 0 0 0 0 0 0 0 0 
0 0 0 0 0 0 0 0 0 0 0 0 0 1 0 0 0 0 0 0 0 0 0 0 0 0 0 0 0 1 1 1 0 0 0 0 0 0 0 0 0 0 0 0 0 0 0 0 0 0 
0 0 0 1 0 0 0 0 0 0 0 0 0 1 d 0 0 0 0 0 0 0 0 0 0 0 0 0 0 b 1 a 0 0 0 0 0 0 0 0 0 0 0 0 0 0 0 0 0 0 
0 0 0 1 0 1 1 1 1 1 1 1 0 1 1 1 d 0 0 0 0 0 0 0 0 0 0 0 0 0 1 0 0 0 0 0 0 0 0 0 0 0 0 0 0 0 0 0 0 0 
0 0 0 1 0 0 0 0 0 0 0 0 0 1 1 1 1 0 0 0 0 0 0 0 0 0 1 d 0 0 1 d 0 0 0 0 c 1 1 1 0 0 0 0 0 0 0 0 0 0 
0 0 0 1 1 1 1 1 1 1 1 1 1 1 1 a 0 0 0 0 0 0 0 0 0 0 1 1 0 0 1 1 1 0 0 0 1 1 a 0 0 0 0 0 0 0 0 0 0 0 
0 0 c 1 0 0 0 0 0 0 0 0 0 1 1 0 0 0 0 0 c 1 1 0 0 c 1 1 d 0 1 1 1 d 0 0 0 0 0 0 0 0 0 0 0 0 0 0 0 0 
SPAWNPOINT 1 1 
TURRET CD 1 BV 8 POS 7 10 DIR 0 W 3.14159 END
TURRET CD 1 BV 8 POS 9 17 DIR 0 W -3.48717 END
TURRET CD 1 BV 8 POS 5 19 DIR 1.88496 W 3.48717 END
TURRET CD 1 BV 8 POS 8 24 DIR 3.14159 W 3.14159 END
TURRET CD 1 BV 8 POS 13 30 DIR 3.14159 W 3.14159 END
TURRET CD 1 BV 8 POS 4 32 DIR 3.14159 W 3.14159 END
TURRET CD 1 BV 8 POS 5 28 DIR 3.14159 W 3.14159 END
TURRET CD 1 BV 8 POS 9 36 DIR 3.14159 W 3.14159 END
TURRET CD 1 BV 8 POS 14 24 DIR 3.14159 W 3.14159 END
TURRET CD 1 BV 8 POS 5 35 DIR 3.14159 W 3.14159 END
TURRET CD 1 BV 30 POS 19 31 DIR 3.14159 W 0.314159 END
TURRET CD 1 BV 30 POS 24 31 DIR 3.14159 W -0.314159 END
TURRET CD 1 BV 30 POS 24 25 DIR 1.5708 W -0.314159 END
TURRET CD 0.2 BV 4 POS 22 39 DIR 1.5708 W 15.708 END
TURRET CD 0.2 BV 4 POS 16 38 DIR 1.5708 W 15.708 END
TURRET CD 0.2 BV 4 POS 27 38 DIR 1.5708 W 15.708 END
TURRET CD 0.2 BV 4 POS 25 42 DIR 1.5708 W 15.708 END
TURRET CD 0.2 BV 4 POS 17 42 DIR 1.5708 W 15.708 END
TURRET CD 0.2 BV 4 POS 21 46 DIR 1.5708 W 15.708 END
TURRET CD 0.2 BV 4 POS 46 44 DIR 0 W 0.314159 END
TURRET CD 0.2 BV 4 POS 43 47 DIR 0 W 0.314159 END
TURRET CD 1 BV 8 POS 44 3 DIR 0 W 3.14159 END
TURRET CD 1 BV 8 POS 38 9 DIR 0 W -3.14159 END
TURRET CD 1 BV 8 POS 45 6 DIR 0 W -3.14159 END
ROCKET_LAUNCHER CD 1 BV 5 DIRECTIONS 1 POS 12 4 DIR -1.5708 W 0 END
ROCKET_LAUNCHER CD 0.9 BV 5 DIRECTIONS 1 POS 16 4 DIR -1.5708 W 0 END
ROCKET_LAUNCHER CD 0.8 BV 5 DIRECTIONS 1 POS 19 4 DIR -1.5708 W 0 END
ROCKET_LAUNCHER CD 1 BV 3 DIRECTIONS 1 POS 31 6 DIR 3.14159 W 0 END
ROCKET_LAUNCHER CD 3 BV 2 DIRECTIONS 1 POS 37 12 DIR 3.14159 W 0 END
ROCKET_LAUNCHER CD 3 BV 2 DIRECTIONS 1 POS 40 13 DIR 3.14159 W 0 END
ROCKET_LAUNCHER CD 3 BV 2 DIRECTIONS 1 POS 43 14 DIR 3.14159 W 0 END
ROCKET_LAUNCHER CD 1.1 BV 4 DIRECTIONS 4 POS 38 44 DIR 0 W 0.314159 END
ROCKET_LAUNCHER CD 1 BV 4 DIRECTIONS 1 POS 43 33 DIR 0 W 0 END
ROCKET_LAUNCHER CD 1 BV 3 DIRECTIONS 1 POS 43 29 DIR 0 W 0 END
ROCKET_LAUNCHER CD 2 BV 1 DIRECTIONS 1 POS 43 22 DIR 0 W 0 END
ROCKET_LAUNCHER CD 1 BV 5 DIRECTIONS 1 POS 43 18 DIR 0 W 0 END
LASER_CARRIER DIRECTIONS 5 POS 25 6 DIR -1.5708 W -0.1 END
LASER_CARRIER DIRECTIONS 3 POS 31 8 DIR 3.14159 W 0.628319 END
LASER_CARRIER DIRECTIONS 1 POS 4 44 DIR 0 W 0 END
LASER_CARRIER DIRECTIONS 1 POS 4 42 DIR 0 W 0 END
LASER_CARRIER DIRECTIONS 6 POS 34 22 DIR 0 W 0.15708 END
LASER_CARRIER DIRECTIONS 3 POS 43 26 DIR 0 W 0.314159 END
EXIT 39 2 
BONUS POS 28 2 TYPE shield END
BONUS POS 34 1 TYPE shield END
BONUS POS 34 2 TYPE shield END
BONUS POS 1 47 TYPE shield END
BONUS POS 40 17 TYPE shield END
TURRET CD 1 BV 5 POS 13 0 DIR 1.755 W 0 END
TURRET CD 1 BV 5 POS 16 1 DIR -0.3375 W 0 END
TURRET CD 1 BV 5 POS 20 1 DIR -1.35 W 0 END
TURRET CD 1 BV 5 POS 22 0 DIR -1.35 W 0.7 END
TURRET CD 1 BV 5 POS 7 8 DIR -1.35 W -0.2 END
TURRET CD 1 BV 1 POS 15 11 DIR -1.35 W -0.2 END
TURRET CD 1 BV 1 POS 21 8 DIR -1.35 W -0.2 END
TURRET CD 1 BV 1 POS 23 12 DIR -1.35 W -0.2 END
TURRET CD 1 BV 1 POS 19 12 DIR -1.35 W -0.2 END
TURRET CD 1 BV 1 POS 20 12 DIR -1.35 W -0.2 END
TURRET CD 1 BV 1 POS 4 0 DIR -1.35 W -0.2 END
END