50 50
0 0 0 0 0 0 0 0 0 0 0 0 0 0 0 0 0 0 0 0 0 0 0 0 0 0 0 0 0 0 0 0 0 0 0 0 0 0 0 0 0 0 0 0 0 0 0 0 0 0 
0 0 0 0 0 0 0 0 0 0 0 0 0 0 0 0 0 0 0 0 0 0 0 0 0 0 0 0 0 0 0 c 1 d 0 0 0 0 0 0 0 0 0 0 0 0 0 0 0 0 
0 0 0 0 0 0 0 0 0 0 0 0 0 0 0 0 0 0 0 0 0 0 0 0 0 0 0 0 0 0 0 1 0 1 0 0 0 0 0 0 0 0 0 0 0 0 0 0 0 0 
0 0 0 0 0 0 0 0 0 0 0 0 0 0 0 0 0 0 0 0 0 0 0 0 0 0 0 0 0 0 c 1 0 1 1 1 1 1 1 1 1 d 0 0 0 0 0 0 0 0 
0 0 0 0 0 c 1 1 1 1 d 0 0 0 0 0 0 0 0 0 0 0 0 0 0 0 0 0 0 c 1 a 0 0 0 0 0 0 0 0 0 b d 0 0 0 0 0 0 0 
0 0 0 0 c a 0 0 0 0 b d 0 0 0 0 0 0 0 0 0 c 1 1 1 1 1 1 1 a 0 0 0 0 0 0 0 0 0 0 0 0 b 1 1 d 0 0 0 0 
0 0 0 c a 0 0 0 0 0 0 b d 0 0 0 0 0 0 0 c a 0 0 0 0 0 0 0 0 0 0 0 0 c 0 0 0 0 0 0 0 0 0 0 b d 0 0 0 
0 0 c a 0 0 0 0 0 2 0 0 b d 0 0 0 0 0 c 1 0 0 0 0 0 0 0 0 0 0 c 1 1 1 0 0 0 0 c a 0 0 0 0 0 b d 0 0 
0 c a 0 2 0 0 0 0 0 0 0 0 b 1 1 1 1 1 1 1 d 0 0 0 0 0 0 0 0 c a 0 0 1 0 0 0 c 2 0 0 0 0 0 0 0 1 0 0 
0 1 0 0 0 0 0 0 0 0 0 a 0 0 0 0 0 0 0 0 2 1 d 0 0 0 0 0 0 c 1 d 0 0 a 0 0 c a 0 0 0 0 0 0 0 0 1 0 0 
0 1 0 0 0 0 0 1 0 0 0 0 0 0 0 0 0 0 0 0 0 2 1 1 1 1 1 1 1 1 1 1 d 0 0 0 0 2 0 0 0 0 d 0 0 0 0 1 0 0 
0 1 0 0 0 0 0 0 0 0 0 0 0 0 0 0 0 0 0 0 0 0 1 a 0 0 0 0 0 0 0 0 b d 0 0 0 0 0 0 0 0 b d 0 0 0 1 0 0 
0 1 0 d 0 0 0 0 0 0 0 2 0 0 0 0 0 c 0 0 0 0 1 0 2 0 0 0 0 0 0 0 0 2 d 0 0 0 0 0 0 0 0 b d 0 0 1 0 0 
0 1 0 0 0 0 0 0 0 0 0 0 0 0 0 c 1 1 2 0 0 0 1 0 0 0 0 0 0 0 2 0 0 0 b d 0 0 0 0 0 0 0 0 0 0 0 1 0 0 
0 1 0 0 0 0 0 0 0 0 0 0 0 0 c a 0 b 0 0 0 c a 0 0 0 c 0 d 0 0 0 0 0 0 b d 0 0 0 c 0 0 0 0 0 0 1 0 0 
0 1 0 0 2 0 0 0 0 b 0 0 0 c a 0 0 0 0 0 c a 0 0 0 0 1 0 1 d 0 0 0 2 0 0 1 0 0 0 2 d 0 0 0 0 0 1 0 0 
0 1 0 0 0 0 0 0 0 0 0 0 c a 0 0 0 0 0 0 1 0 0 0 c 0 1 0 0 0 0 0 0 0 0 0 1 0 0 0 0 b d 0 0 0 0 1 0 0 
0 1 0 0 0 0 0 0 0 0 0 c a 0 0 b d 0 0 0 1 0 0 0 1 0 1 0 1 1 0 0 0 0 0 0 1 0 0 0 0 0 b 0 0 0 0 1 0 0 
0 1 0 0 0 0 0 0 0 0 c a 0 0 0 0 b d 0 0 1 0 0 0 0 0 0 1 0 0 0 0 0 0 0 0 1 0 0 0 0 0 0 0 0 0 0 1 0 0 
0 1 0 0 0 0 0 0 0 0 1 0 c a 0 0 0 0 0 c 1 0 0 0 1 1 1 1 1 1 0 0 1 1 1 1 1 0 0 0 0 0 0 0 0 0 0 1 0 0 
0 1 0 0 0 0 c a 0 0 1 0 0 0 0 0 1 1 1 1 1 0 0 0 0 0 0 1 1 1 0 0 0 0 0 0 1 0 0 0 0 2 0 0 0 0 0 1 0 0 
0 1 d c 1 a 0 0 0 0 b d 0 0 0 0 0 0 0 1 1 0 0 0 1 1 1 1 1 1 d 0 0 0 0 c 1 0 0 0 0 0 0 0 0 0 c 1 d 0 
0 1 a 0 0 0 0 0 0 0 0 b 1 1 1 1 1 1 1 1 1 0 0 0 b 1 1 1 1 1 1 1 1 1 1 1 a 0 0 0 c 1 1 1 1 a 0 b 1 0 
0 1 0 0 0 0 0 0 0 0 0 0 1 0 0 0 0 0 0 0 1 0 0 0 0 0 0 0 1 0 0 0 0 0 0 1 0 0 0 0 1 0 0 b 1 0 0 0 1 0 
0 1 0 0 0 0 0 0 0 0 0 0 1 0 0 0 0 0 0 0 1 0 0 0 0 0 0 0 1 0 0 0 0 0 0 1 0 0 0 0 1 0 0 0 1 0 1 0 1 0 
0 1 d 0 0 0 0 0 0 0 0 0 1 0 0 0 0 0 0 0 1 0 0 0 0 0 0 0 1 0 0 0 0 0 0 1 0 0 0 0 1 0 0 c a 0 0 0 1 0 
0 b 1 1 1 1 1 1 1 1 1 1 1 1 1 0 0 0 1 1 1 1 1 1 1 1 1 1 1 1 0 0 0 0 1 1 1 1 1 1 1 1 1 a 0 0 0 0 1 0 
0 0 b 1 a 0 0 0 0 0 0 0 0 0 1 0 0 0 0 0 0 0 0 0 1 0 0 0 1 0 0 0 0 0 0 0 0 0 0 0 0 0 0 0 c 0 0 0 1 0 
0 0 0 1 0 0 0 0 0 0 0 0 0 0 1 0 0 0 0 0 0 0 0 0 1 0 0 0 1 0 0 0 0 0 0 0 0 0 0 0 0 0 0 0 1 0 0 0 1 0 
0 0 0 1 1 0 0 0 0 0 0 0 0 0 1 0 0 0 0 0 0 0 0 0 0 0 0 0 1 0 0 0 0 c a 0 0 0 0 0 0 0 0 0 b d 0 0 1 0 
0 0 0 1 0 0 0 0 0 0 2 1 1 1 1 1 1 1 1 1 1 1 1 0 0 0 0 0 1 0 0 0 c 2 0 0 0 b d 0 0 0 0 0 c a 0 0 1 0 
0 0 0 1 0 0 0 0 0 0 0 0 0 0 0 0 0 0 0 0 0 0 0 0 0 0 0 0 1 0 0 2 a 0 0 0 0 0 2 2 0 0 0 0 b d 0 0 1 0 
0 0 0 1 0 0 0 0 0 0 0 0 0 0 0 0 0 0 0 0 0 0 0 2 0 0 0 0 1 0 0 a 0 0 0 0 0 0 0 b d 0 0 0 0 0 0 0 1 0 
0 0 0 1 1 0 0 0 0 2 0 0 0 0 0 0 0 0 0 0 0 0 0 0 0 0 0 0 1 0 0 0 0 0 0 0 0 0 0 0 2 d 0 0 d 0 0 0 1 0 
0 0 0 1 0 0 0 0 0 0 0 0 0 0 0 0 0 2 0 0 0 0 0 0 0 0 0 0 1 0 0 0 0 0 0 0 0 0 0 0 0 b 2 0 0 0 0 0 1 0 
0 0 0 1 0 0 0 0 0 0 0 0 0 0 0 0 0 0 0 0 0 0 0 0 0 0 0 0 1 0 0 0 0 0 0 0 0 0 0 0 0 0 b 0 0 0 0 0 1 0 
0 0 0 1 d 0 0 0 0 2 0 0 0 0 0 0 0 0 0 0 0 2 0 0 0 0 0 0 1 0 0 0 0 d 0 0 0 0 0 0 0 0 0 0 0 0 0 0 1 0 
0 0 0 b 1 d 0 0 0 0 0 1 0 0 0 0 1 0 0 0 0 0 0 0 1 0 0 0 1 0 0 0 0 b 1 1 d 0 0 0 0 0 0 0 c 0 0 0 1 0 
0 0 0 0 b 1 1 1 1 1 1 1 1 1 1 1 1 1 1 1 1 1 1 1 1 1 1 1 1 0 0 0 0 0 0 0 b 0 0 0 b d c 1 a 0 0 c 1 0 
0 0 0 0 0 0 0 0 0 0 0 0 0 0 0 0 0 0 0 0 0 0 0 0 0 0 0 0 1 0 0 0 0 0 0 0 0 0 0 0 0 b a 0 0 0 0 1 a 0 
0 0 0 0 0 0 0 0 0 0 0 0 0 0 0 0 0 0 0 0 0 0 0 0 0 0 0 0 b d 0 0 0 0 0 0 0 0 0 0 0 0 0 0 0 0 c a 0 0 
0 0 0 0 0 0 0 0 0 0 0 0 0 0 0 0 0 0 0 0 0 0 0 0 0 0 0 0 0 b d 0 0 0 0 0 0 0 0 0 0 0 0 0 0 c a 0 0 0 
0 0 0 0 0 0 0 0 0 0 0 0 0 0 0 0 0 0 0 0 0 0 0 0 0 0 0 0 0 0 b 1 1 1 1 1 1 1 1 1 1 1 1 1 1 a 0 0 0 0 
0 0 0 0 0 0 0 0 0 0 0 0 0 0 0 0 0 0 0 0 0 0 0 0 0 0 0 0 0 0 0 0 0 0 0 0 0 0 0 0 0 0 0 0 0 0 0 0 0 0 
0 0 0 0 0 0 0 0 0 0 0 0 0 0 0 0 0 0 0 0 0 0 0 0 0 0 0 0 0 0 0 0 0 0 0 0 0 0 0 0 0 0 0 0 0 0 0 0 0 0 
0 0 0 0 0 0 0 0 0 0 0 0 0 0 0 0 0 0 0 0 0 0 0 0 0 0 0 0 0 0 0 0 0 0 0 0 0 0 0 0 0 0 0 0 0 0 0 0 0 0 
0 0 0 0 0 0 0 0 0 0 0 0 0 0 0 0 0 0 0 0 0 0 0 0 0 0 0 0 0 0 0 0 0 0 0 0 0 0 0 0 0 0 0 0 0 0 0 0 0 0 
0 0 0 0 0 0 0 0 0 0 0 0 0 0 0 0 0 0 0 0 0 0 0 0 0 0 0 0 0 0 0 0 0 0 0 0 0 0 0 0 0 0 0 0 0 0 0 0 0 0 
0 0 0 0 0 0 0 0 0 0 0 0 0 0 0 0 0 0 0 0 0 0 0 0 0 0 0 0 0 0 0 0 0 0 0 0 0 0 0 0 0 0 0 0 0 0 0 0 0 0 
0 0 0 0 0 0 0 0 0 0 0 0 0 0 0 0 0 0 0 0 0 0 0 0 0 0 0 0 0 0 0 0 0 0 0 0 0 0 0 0 0 0 0 0 0 0 0 0 0 0 
COLORS 
0 0 0 0 0 0 0 0 0 0 0 0 0 0 0 0 0 0 0 0 0 0 0 0 0 0 0 0 0 0 0 0 0 0 0 0 0 0 0 0 0 0 0 0 0 0 0 0 0 0 
0 0 0 0 0 0 0 0 0 0 0 0 0 0 0 0 0 0 0 0 0 0 0 0 0 0 0 0 0 0 0 0 0 0 0 0 0 0 0 0 0 0 0 0 0 0 0 0 0 0 
0 0 0 0 0 0 0 0 0 0 0 0 0 0 0 0 0 0 0 0 0 0 0 0 0 0 0 0 0 0 0 0 0 0 0 0 0 0 0 0 0 0 0 0 0 0 0 0 0 0 
0 0 0 0 0 0 0 0 0 0 0 0 0 0 0 0 0 0 0 0 0 0 0 0 0 0 0 0 0 0 0 0 0 0 0 0 0 0 0 0 0 0 0 0 0 0 0 0 0 0 
0 0 0 0 0 0 0 0 0 0 0 0 0 0 0 0 0 0 0 0 0 0 0 0 0 0 0 0 0 0 0 0 0 0 0 0 0 0 0 0 0 0 0 0 0 0 0 0 0 0 
0 0 0 0 0 0 0 0 0 0 0 0 0 0 0 0 0 0 0 0 0 0 0 0 0 0 0 0 0 0 0 0 0 0 0 0 0 0 0 0 0 0 0 0 0 0 0 0 0 0 
0 0 0 0 0 0 0 0 0 0 0 0 0 0 0 0 0 0 0 0 0 0 0 0 0 0 0 0 0 0 0 0 0 0 0 0 0 0 0 0 0 0 0 0 0 0 0 0 0 0 
0 0 0 0 0 0 0 0 0 1 0 0 0 0 0 0 0 0 0 0 0 0 0 0 0 0 0 0 0 0 0 0 0 0 0 0 0 0 0 0 0 0 0 0 0 0 0 0 0 0 
0 0 0 0 1 0 0 0 0 0 0 0 0 0 0 0 0 0 0 0 0 0 0 0 0 0 0 0 0 0 0 0 0 0 0 0 0 0 0 0 0 0 0 0 0 0 0 0 0 0 
0 0 0 0 0 0 1 0 0 0 0 1 0 0 0 0 0 0 0 0 0 0 0 0 0 0 0 0 0 0 0 0 0 0 0 0 0 0 0 0 0 0 0 0 0 0 0 0 0 0 
0 0 0 0 0 0 0 1 0 0 0 0 0 0 0 0 0 0 0 0 0 0 0 0 0 0 0 0 0 0 0 0 0 0 0 0 0 0 0 0 0 0 0 0 0 0 0 0 0 0 
0 0 0 0 0 0 0 1 1 0 0 0 0 0 0 0 0 0 0 0 0 0 0 0 0 0 0 0 0 0 0 0 0 0 0 0 0 0 0 0 0 0 0 0 0 0 0 0 0 0 
0 0 0 1 0 0 0 0 0 0 0 1 0 0 0 0 0 0 0 0 0 0 0 0 0 0 0 0 0 0 0 0 0 0 0 0 0 0 0 0 0 0 0 0 0 0 0 0 0 0 
0 0 0 0 0 0 0 0 0 1 0 0 0 0 0 1 1 0 0 0 0 0 0 0 0 0 0 0 0 0 0 0 0 0 0 0 0 0 0 0 0 0 0 0 0 0 0 0 0 0 
0 0 0 0 0 0 0 1 0 0 0 0 0 0 0 1 0 0 0 0 0 0 0 0 0 0 0 0 0 0 0 0 0 0 0 0 0 0 0 0 0 0 0 0 0 0 0 0 0 0 
0 0 0 1 1 1 0 0 0 1 0 0 0 0 0 0 0 0 0 0 0 0 0 0 0 0 0 0 0 0 0 0 0 0 0 0 0 0 0 0 0 0 0 0 0 0 0 0 0 0 
0 0 0 0 0 0 0 0 0 0 0 0 0 0 0 0 0 0 0 0 0 0 0 0 0 0 0 0 0 0 0 0 0 0 0 0 0 0 0 0 0 0 0 0 0 0 0 0 0 0 
0 0 0 0 0 0 0 0 0 0 0 0 0 0 0 0 0 0 0 0 0 0 0 0 0 0 0 0 0 0 0 0 0 0 0 0 0 0 0 0 0 0 0 0 0 0 0 0 0 0 
0 0 0 0 0 0 0 0 0 0 0 0 0 0 0 0 0 0 0 0 0 0 0 0 0 0 0 0 0 0 0 0 0 0 0 0 0 0 0 0 0 0 0 0 0 0 0 0 0 0 
0 0 0 0 0 0 0 0 0 0 0 0 0 0 0 0 0 0 0 0 0 0 0 0 0 0 0 0 0 0 0 0 0 0 0 0 0 0 0 0 0 0 0 0 0 0 0 0 0 0 
0 0 0 0 0 0 0 0 0 0 0 0 0 0 0 0 0 0 0 0 0 0 0 0 0 0 0 0 0 0 0 0 0 0 3 0 0 0 0 0 0 0 0 0 0 0 0 0 0 0 
0 0 0 0 0 0 0 0 0 0 0 0 0 0 0 0 0 0 0 0 0 0 0 0 0 0 0 0 0 0 0 0 0 0 0 0 0 0 0 0 0 0 0 0 0 0 0 0 0 0 
0 0 0 0 0 0 0 0 0 0 0 0 0 0 0 0 0 0 0 0 0 0 0 0 0 0 0 0 0 0 0 0 0 0 0 0 0 0 0 0 0 0 0 0 0 0 0 0 0 0 
0 0 0 0 0 0 0 0 0 0 0 0 1 0 0 0 0 0 0 0 2 0 0 0 0 0 0 0 3 0 0 0 0 0 0 4 0 0 0 0 5 0 0 0 0 0 0 0 0 0 
0 0 0 0 0 0 0 0 0 0 0 0 1 0 0 0 0 0 0 0 2 5 0 0 0 0 0 0 3 0 0 0 0 0 0 4 0 0 0 0 5 0 0 0 0 0 0 0 0 0 
0 0 0 0 0 0 0 0 0 0 0 0 1 0 0 0 0 0 0 0 2 0 0 0 0 0 0 0 3 3 0 0 0 0 0 4 4 0 0 0 5 0 0 0 0 0 0 0 0 0 
0 0 0 0 0 0 0 0 0 0 0 0 0 0 0 0 0 0 0 0 0 0 0 0 0 0 0 0 0 0 0 0 0 0 0 0 0 0 0 0 0 0 0 0 0 0 0 0 0 0 
0 0 0 0 0 0 2 2 0 0 0 0 0 0 2 0 0 0 0 0 0 0 0 0 2 0 0 0 0 0 0 0 0 0 0 0 0 0 0 0 0 0 0 0 0 0 0 0 0 0 
0 0 0 0 2 2 2 0 0 0 0 0 0 0 2 0 0 0 0 0 0 0 0 0 2 2 0 4 0 0 0 0 0 0 0 0 0 0 0 0 0 0 0 0 0 0 0 0 0 0 
0 0 0 0 2 2 0 0 0 0 0 0 0 0 2 0 0 0 0 0 0 0 0 0 0 0 0 0 0 0 0 0 0 0 0 0 0 0 0 0 0 0 0 0 0 0 0 0 0 0 
0 0 0 0 2 2 0 0 0 0 0 0 0 0 0 0 0 0 2 2 2 2 2 0 0 0 0 0 0 0 0 0 0 0 0 0 0 0 0 0 0 0 0 0 0 0 0 0 0 0 
0 0 0 0 2 2 0 0 0 0 0 0 0 0 0 0 0 0 0 0 0 0 0 0 0 0 0 0 0 0 0 0 0 0 0 0 0 0 0 0 0 0 0 0 0 0 0 0 0 0 
0 0 0 0 2 2 0 0 0 0 0 0 0 0 0 0 2 0 0 0 0 0 0 0 0 0 0 0 0 0 0 0 0 0 0 0 0 0 0 0 0 0 0 0 0 0 0 0 0 0 
0 0 0 0 2 2 0 0 0 0 0 0 0 0 0 0 2 0 0 0 0 0 0 0 0 0 0 0 0 0 0 0 0 0 0 0 0 0 0 0 0 0 0 0 0 0 0 0 0 0 
0 0 0 0 2 2 0 0 0 0 0 0 0 0 2 2 2 0 2 0 0 0 0 0 0 0 0 0 0 0 0 0 0 0 0 0 0 0 0 0 0 0 0 0 0 0 0 0 0 0 
0 0 0 0 2 2 2 0 0 0 0 0 0 0 0 0 0 0 0 0 0 0 0 0 0 0 0 0 0 0 0 0 0 0 0 0 0 0 0 0 0 0 0 0 0 0 0 0 0 0 
0 0 0 0 0 2 2 2 2 0 2 2 2 2 2 2 2 2 2 2 2 0 2 2 2 2 2 2 0 0 0 0 0 0 0 0 0 0 0 0 0 0 0 0 0 0 0 0 0 0 
0 0 0 0 0 0 2 2 2 0 2 2 2 0 2 0 2 0 0 0 0 0 0 2 2 2 0 0 0 0 0 0 0 0 0 0 0 0 0 0 0 0 0 0 0 0 0 0 0 0 
0 0 0 0 0 0 0 0 0 0 0 0 0 0 0 0 0 0 0 0 0 0 0 0 0 0 0 0 0 0 0 0 0 0 0 0 0 0 0 0 0 0 0 0 0 0 0 0 0 0 
0 0 0 0 0 0 0 0 0 0 0 0 0 0 0 0 0 0 0 0 0 0 0 0 0 0 0 0 0 0 0 0 0 0 0 0 0 0 0 0 0 0 0 0 0 0 0 0 0 0 
0 0 0 0 0 0 0 0 0 0 0 0 0 0 0 0 0 0 0 0 0 0 0 0 0 0 0 0 0 0 0 0 0 0 0 0 0 0 0 0 0 0 0 0 0 0 0 0 0 0 
0 0 0 0 0 0 0 0 0 0 0 0 0 0 0 0 0 0 0 0 0 0 0 0 0 0 0 0 0 0 0 0 0 0 0 0 0 0 0 0 0 0 0 0 0 0 0 0 0 0 
0 0 0 0 0 0 0 0 0 0 0 0 0 0 0 0 0 0 0 0 0 0 0 0 0 0 0 0 0 0 0 0 0 0 0 0 0 0 0 0 0 0 0 0 0 0 0 0 0 0 
0 0 0 0 0 0 0 0 0 0 0 0 0 0 0 0 0 0 0 0 0 0 0 0 0 0 0 0 0 0 0 0 0 0 0 0 0 0 0 0 0 0 0 0 0 0 0 0 0 0 
0 0 0 0 0 0 0 0 0 0 0 0 0 0 0 0 0 0 0 0 0 0 0 0 0 0 0 0 0 0 0 0 0 0 0 0 0 0 0 0 0 0 0 0 0 0 0 0 0 0 
0 0 0 0 0 0 0 0 0 0 0 0 0 0 0 0 0 0 0 0 0 0 0 0 0 0 0 0 0 0 0 0 0 0 0 0 0 0 0 0 0 0 0 0 0 0 0 0 0 0 
0 0 0 0 0 0 0 0 0 0 0 0 0 0 0 0 0 0 0 0 0 0 0 0 0 0 0 0 0 0 0 0 0 0 0 0 0 0 0 0 0 0 0 0 0 0 0 0 0 0 
0 0 0 0 0 0 0 0 0 0 0 0 0 0 0 0 0 0 0 0 0 0 0 0 0 0 0 0 0 0 0 0 0 0 0 0 0 0 0 0 0 0 0 0 0 0 0 0 0 0 
0 0 0 0 0 0 0 0 0 0 0 0 0 0 0 0 0 0 0 0 0 0 0 0 0 0 0 0 0 0 0 0 0 0 0 0 0 0 0 0 0 0 0 0 0 0 0 0 0 0 
0 0 0 0 0 0 0 0 0 0 0 0 0 0 0 0 0 0 0 0 0 0 0 0 0 0 0 0 0 0 0 0 0 0 0 0 0 0 0 0 0 0 0 0 0 0 0 0 0 0 
SPAWNPOINT 3 24 
EXIT 42 24 
LASER_CARRIER DIRECTIONS 6 POS 7 10 DIR 0 W -0.628319 END
GENERATOR COLOR 1 POS 18 21 DIR 0 W 0 END
TURRET CD 0.25 BV 3.5 POS 13 18 DIR 0 W 12.5664 END
TURRET CD 0.25 BV 3.5 POS 19 17 DIR 4.45059 W 12.5664 END
TURRET CD 0.25 BV 3.5 POS 14 20 DIR 2.87979 W 12.5664 END
TURRET CD 0.25 BV 3.5 POS 15 15 DIR 0.785398 W 12.5664 END
TURRET CD 1 BV 5 POS 4 10 DIR 0.785398 W 7.53982 END
TURRET CD 1 BV 5 POS 4 18 DIR 0.785398 W 7.53982 END
TURRET CD 1 BV 5 POS 7 6 DIR 0.785398 W 7.53982 END
TURRET CD 1 BV 5 POS 12 14 DIR 0.785398 W 7.53982 END
TURRET CD 1 BV 5 POS 6 14 DIR 5.75959 W 7.53982 END
TURRET CD 1 BV 5 POS 8 12 DIR 4.18879 W -5.65487 END
GENERATOR COLOR 2 POS 25 28 DIR 0 W 0 END
LASER_CARRIER DIRECTIONS 1 POS 18 30 DIR 4.71239 W 0 END
LASER_CARRIER DIRECTIONS 1 POS 19 30 DIR 4.71239 W 0 END
LASER_CARRIER DIRECTIONS 1 POS 20 30 DIR 4.71239 W 0 END
LASER_CARRIER DIRECTIONS 1 POS 21 30 DIR 4.71239 W 0 END
LASER_CARRIER DIRECTIONS 1 POS 22 30 DIR 4.71239 W 0 END
TURRET CD 1 BV 5 POS 8 31 DIR 2.87979 W -4.39823 END
TURRET CD 1 BV 5 POS 11 33 DIR 2.87979 W -4.39823 END
TURRET CD 1 BV 5 POS 15 33 DIR 2.87979 W -4.39823 END
TURRET CD 1 BV 5 POS 18 32 DIR 2.87979 W -4.39823 END
TURRET CD 1 BV 5 POS 19 33 DIR 2.87979 W -4.39823 END
TURRET CD 1 BV 5 POS 8 34 DIR 2.87979 W -4.39823 END
TURRET CD 1 BV 5 POS 7 32 DIR 2.87979 W -4.39823 END
TURRET CD 1 BV 5 POS 9 28 DIR 2.87979 W -4.39823 END
ROBOT CD 1 BV 5 MF 15 SHIELDS 0 POS 11 37 DIR 2.87979 W -4.39823 END
ROBOT CD 0.7 BV 1.5 MF 15 SHIELDS 0 POS 16 37 DIR 4.45059 W -19.4779 END
ROBOT CD 0.7 BV 1.5 MF 15 SHIELDS 0 POS 4 29 DIR 4.45059 W -19.4779 END
ROBOT CD 0.7 BV 1.5 MF 15 SHIELDS 0 POS 4 33 DIR 4.45059 W -19.4779 END
ROBOT CD 0.7 BV 1.5 MF 15 SHIELDS 0 POS 24 37 DIR 4.45059 W -19.4779 END
BONUS POS 12 20 TYPE shield END
BONUS POS 14 28 TYPE shield END
BONUS POS 12 24 TYPE shield END
BONUS POS 20 24 TYPE shield END
BONUS POS 28 24 TYPE shield END
BONUS POS 35 24 TYPE shield END
BONUS POS 40 24 TYPE shield END
ROCKET_LAUNCHER CD 1.6 BV 5 DIRECTIONS 1 POS 26 20 DIR 3.14159 W 0 END
ROCKET_LAUNCHER CD 1.45 BV 5 DIRECTIONS 1 POS 26 18 DIR 3.14159 W 0 END
ROCKET_LAUNCHER CD 1.25 BV 5 DIRECTIONS 1 POS 25 17 DIR 4.71239 W 0 END
ROCKET_LAUNCHER CD 1.8 BV 3 DIRECTIONS 1 POS 27 17 DIR 4.71239 W 0 END
ROCKET_LAUNCHER CD 1.1 BV 10 DIRECTIONS 1 POS 28 16 DIR 6.28319 W 0 END
ROCKET_LAUNCHER CD 1.15 BV 10 DIRECTIONS 1 POS 28 18 DIR 6.28319 W 0 END
BONUS POS 34 17 TYPE shield END
GENERATOR COLOR 3 POS 35 20 DIR 0 W 0 END
GENERATOR COLOR 4 POS 46 23 DIR 0 W 0 END
LASER_CARRIER DIRECTIONS 5 POS 36 33 DIR 6.28319 W 0.628319 END
LASER_CARRIER DIRECTIONS 1 POS 42 31 DIR 6.02139 W 0.628319 END
LASER_CARRIER DIRECTIONS 1 POS 33 39 DIR 4.97419 W -0.628319 END
LASER_CARRIER DIRECTIONS 1 POS 46 36 DIR 4.97419 W -0.628319 END
GENERATOR COLOR 5 POS 22 7 DIR 0 W 0 END
GENERATOR COLOR 5 POS 45 8 DIR 0 W 0 END
GENERATOR COLOR 5 POS 32 8 DIR 0 W 0 END
ROBOT CD 1 BV 3.5 MF 15 SHIELDS 0 POS 42 14 DIR 4.97419 W -10.0531 END
ROBOT CD 1 BV 3.5 MF 15 SHIELDS 0 POS 39 5 DIR 2.61799 W -8.16814 END
ROBOT CD 1 BV 2.5 MF 15 SHIELDS 0 POS 25 8 DIR 2.61799 W 18.8496 END
ROBOT CD 3 BV 7 MF 15 SHIELDS 0 POS 45 15 DIR 0.523599 W 4.39823 END
ROBOT CD 3 BV 7 MF 15 SHIELDS 0 POS 38 18 DIR 0.523599 W 4.39823 END
ROCKET_LAUNCHER CD 2.3 BV 3 DIRECTIONS 1 POS 43 6 DIR 2.35619 W 0 END
ROCKET_LAUNCHER CD 2.3 BV 3.5 DIRECTIONS 1 POS 45 21 DIR 3.14159 W 0 END
ROCKET_LAUNCHER CD 2.35 BV 3.5 DIRECTIONS 1 POS 32 2 DIR 1.5708 W 0 END
TURRET CD 1.05 BV 5 POS 41 12 DIR 0.785398 W 8.79646 END
TURRET CD 1.05 BV 5 POS 28 6 DIR 0.785398 W 8.79646 END
TURRET CD 1.05 BV 5 POS 41 17 DIR 0.785398 W 8.79646 END
TURRET CD 1.05 BV 5 POS 45 10 DIR 0.785398 W 8.79646 END
TURRET CD 1.05 BV 5 POS 44 7 DIR 6.02139 W 8.79646 END
END