50 50
0 0 0 0 b 1 0 0 0 0 0 0 0 0 0 0 0 0 0 0 0 0 0 0 0 0 0 0 0 0 0 0 0 0 0 0 0 0 1 1 a 0 0 0 b 1 1 1 1 1 
0 0 0 0 0 b d 0 0 0 0 0 0 0 0 0 0 0 0 0 0 0 0 0 0 0 0 0 0 0 0 0 0 0 0 0 1 1 1 1 0 0 0 0 0 0 0 0 0 b 
0 0 0 0 0 0 b d 0 0 0 0 0 0 0 0 0 0 0 0 0 0 0 0 0 0 0 0 0 0 0 0 0 0 0 0 0 0 1 1 1 1 1 1 1 1 d 0 0 0 
d 0 0 0 0 0 0 b 2 0 0 0 0 0 c 1 1 1 1 1 d 0 0 0 0 0 0 0 0 0 0 0 0 0 c 1 1 1 1 a 0 0 0 0 0 0 b d 0 0 
1 1 1 1 1 0 0 0 1 d 0 0 0 2 a 0 0 0 0 b 1 2 0 0 0 0 0 0 0 0 0 0 0 c 1 a 0 0 0 0 0 0 0 0 0 0 0 b 1 1 
a 0 0 0 0 0 0 0 b 1 0 0 c a 0 0 0 0 0 0 0 b d 0 0 0 0 0 0 0 c 1 1 1 1 0 0 0 0 0 0 0 0 0 0 0 0 0 0 0 
0 0 0 0 0 0 0 0 0 1 0 0 1 0 0 0 0 0 0 0 0 0 b 1 0 0 0 0 0 0 2 a 0 b 1 0 0 c d 0 0 0 0 0 0 0 0 0 0 0 
0 0 0 0 0 0 0 0 0 1 0 0 1 0 0 0 0 c d 0 0 0 0 0 0 0 0 0 0 0 0 0 0 0 1 0 0 b a 0 c 1 1 d 0 0 0 0 0 0 
0 0 0 0 0 0 0 0 0 1 0 0 b d 0 0 c a b d 0 0 0 0 0 0 0 0 0 0 0 0 0 0 1 0 0 0 0 0 1 a 0 b 1 d 0 0 0 0 
0 0 0 0 0 0 0 0 c 1 0 0 0 2 d c a 0 0 b 1 1 1 1 d 0 0 0 0 0 0 0 0 0 1 0 0 0 0 0 1 0 0 0 0 b d 0 0 0 
0 0 0 0 0 0 0 0 1 a 0 0 0 0 b 1 0 0 0 0 0 0 0 0 b d 0 0 0 0 0 0 0 0 1 0 0 0 0 0 1 0 0 0 0 0 1 0 0 0 
0 0 0 0 0 0 0 0 1 0 0 0 0 0 0 1 0 0 0 0 0 0 0 0 0 1 d 0 0 0 0 0 0 c a 0 0 1 0 0 1 0 0 0 0 c 1 0 0 0 
0 0 0 0 0 0 0 0 1 0 0 0 0 0 0 b d 0 0 0 0 0 0 0 0 1 1 0 0 0 0 0 c a 0 0 c a 0 0 1 d 0 0 c 1 a 0 0 0 
0 0 0 0 0 0 0 c a 0 0 0 0 0 0 0 b d 0 0 0 0 0 0 0 b 1 d 0 0 0 c 2 0 0 0 1 0 0 0 1 1 1 1 a 0 0 0 0 0 
0 0 0 0 0 0 c a 0 0 0 0 c 1 0 0 0 1 d 0 0 0 0 0 0 0 0 2 0 0 c a 0 0 0 0 0 0 0 c a 0 0 0 0 c 2 0 0 0 
0 0 0 0 0 c 1 d 0 0 0 c a 0 0 0 0 0 b d 0 0 0 0 0 0 0 0 0 c a 0 0 0 0 0 0 0 c a 0 0 0 0 0 2 a 0 0 0 
0 0 0 0 1 1 1 1 1 1 1 a 0 0 0 0 0 0 0 b 1 1 d 0 0 0 0 0 c 2 0 0 c d 0 0 0 2 a 0 0 0 0 0 0 0 0 0 0 0 
0 0 0 0 2 a 0 0 0 0 0 0 0 0 c d 0 0 0 0 0 0 b 1 1 1 1 1 1 1 0 0 b a 0 0 c 1 d 0 0 0 0 0 0 0 0 0 0 0 
0 0 0 0 0 0 0 0 0 0 0 0 0 0 b 1 d 0 0 0 0 0 0 b 1 0 0 0 0 1 0 0 0 0 0 c a 0 1 0 0 0 0 2 d 0 0 0 0 0 
0 0 0 0 0 0 0 0 0 0 0 0 0 0 0 b a 0 0 0 0 0 0 0 b 1 1 1 2 1 0 2 2 1 2 a 0 0 1 0 0 0 0 b 2 1 1 2 1 1 
2 d 0 2 2 2 1 1 2 d 0 c 1 1 d 0 0 0 0 0 1 d 0 0 0 1 0 0 0 1 0 0 0 b 1 0 0 0 1 0 0 2 0 0 0 0 0 0 0 0 
1 2 2 1 a 0 0 b 1 1 1 1 0 0 b d 0 0 0 c 1 1 d 0 0 1 1 1 1 2 0 0 0 0 b d 0 0 1 0 0 0 0 0 0 0 0 0 0 0 
1 1 a 0 0 0 0 0 2 0 b a 0 0 c a 0 0 c a 0 b 1 0 0 1 0 0 0 1 0 0 0 0 0 2 d 0 1 0 0 0 0 0 0 c 2 0 0 0 
a 0 0 0 0 2 0 0 2 0 0 0 0 0 1 0 0 0 1 0 0 0 1 0 0 1 1 1 1 1 0 0 2 0 c a b 1 a 0 0 0 0 0 c a 0 0 0 0 
0 0 0 2 0 2 0 0 2 0 0 2 0 0 0 0 0 0 1 0 0 0 1 0 0 b 1 0 0 1 0 0 0 0 2 0 0 2 d 0 0 0 0 2 a 0 0 0 0 c 
0 0 0 2 0 2 0 0 0 0 0 2 0 0 0 0 0 0 1 0 0 0 1 0 0 0 b 1 1 1 d 0 0 0 b 1 1 a b 1 d 0 0 0 0 0 0 0 2 2 
0 0 0 2 0 2 0 0 0 0 0 2 0 0 0 0 0 c 1 0 0 0 1 0 0 0 0 0 0 b 1 1 1 d 0 0 0 0 0 b 1 1 1 1 1 d 0 0 0 0 
0 0 0 b 2 2 0 2 2 0 2 2 0 1 1 1 1 1 a 0 0 0 1 0 0 0 0 0 0 0 1 0 0 1 0 0 0 0 0 0 1 a 0 0 b 1 0 0 0 0 
d 0 0 0 b 1 0 1 1 0 1 1 0 1 a 0 0 0 0 0 0 0 1 0 0 0 0 0 0 0 1 0 0 1 0 0 0 0 0 0 1 0 0 0 0 1 0 c 2 0 
1 d 0 0 0 1 0 1 1 0 1 1 0 1 0 0 0 0 0 0 0 0 1 0 0 0 0 0 0 0 1 0 0 1 0 0 c d 0 0 1 0 0 0 0 1 0 2 a 0 
1 1 0 0 0 b 1 1 1 1 1 1 1 a 0 0 0 2 0 0 0 0 1 0 0 0 0 0 0 0 1 0 0 1 0 0 b a 0 0 1 0 0 0 0 1 0 0 0 c 
1 1 0 0 0 0 0 0 2 a 0 b 1 0 0 0 0 0 0 0 2 0 1 0 0 0 0 0 0 0 1 0 0 1 0 0 0 0 c 1 1 0 0 0 0 1 2 d 0 2 
1 a 0 0 0 0 0 0 0 0 0 0 1 0 0 0 0 0 0 0 0 0 1 0 0 0 0 0 0 0 1 1 1 a 0 0 0 c a 0 1 0 0 0 0 1 2 2 0 0 
1 0 0 0 0 0 0 0 0 0 0 0 1 0 0 0 0 0 0 0 0 0 1 0 0 0 0 0 0 c a 0 0 0 0 0 c a 0 0 1 d 0 0 c 1 0 0 0 0 
a 0 0 0 0 0 0 0 0 0 0 0 1 0 0 0 0 2 0 0 0 0 1 0 0 0 0 0 2 a 0 0 0 0 0 c a 0 0 c 1 1 1 1 1 a 0 0 0 0 
0 0 0 0 0 2 d 0 0 0 0 0 1 0 0 0 0 0 0 0 0 0 1 0 0 0 0 c a 0 c d 0 0 c a 0 0 c 1 1 a 0 0 0 0 0 0 0 0 
0 0 0 0 0 b 1 d 0 0 0 0 1 0 0 0 0 0 0 0 0 0 1 0 0 0 2 a 0 0 2 2 0 c a 0 0 c a 0 0 0 0 0 0 0 0 0 0 0 
0 0 0 0 0 0 b 2 0 0 0 0 1 0 0 0 0 0 0 0 0 0 1 0 0 0 1 d 0 0 b a 0 1 0 c 1 a 0 0 0 0 0 0 0 0 0 0 0 0 
0 0 0 0 0 0 0 0 0 0 0 0 1 0 0 2 1 1 1 d 0 c 1 0 0 c 1 1 d 0 0 0 c 1 1 1 a 0 0 0 0 0 0 0 0 0 c d 0 0 
d 0 0 0 c 2 0 0 0 0 0 0 1 0 0 0 0 0 b 1 1 1 a 0 c a 0 b 1 0 0 c a 0 0 0 0 0 0 1 0 0 0 0 0 0 b a 0 0 
a 0 0 0 2 a 0 0 0 0 0 c 1 d 0 0 0 0 0 1 1 1 0 0 1 0 0 0 0 0 c a 0 0 0 0 0 0 0 0 0 0 0 0 0 0 0 0 0 0 
0 0 0 0 0 0 0 0 0 0 2 a 0 1 1 2 0 0 2 a b 1 0 0 1 d 0 0 0 c a 0 0 0 0 0 0 0 0 0 c 1 1 1 1 d 0 0 0 0 
0 0 0 0 0 0 0 0 0 c a 0 c a 0 0 0 0 0 0 0 1 0 0 b 1 1 1 1 a 0 0 0 c d 0 0 0 c 1 a 0 0 0 b 1 1 1 d 0 
d 0 0 0 0 0 0 0 2 a 0 0 2 0 0 0 0 0 0 0 0 1 0 0 0 1 0 1 0 0 0 0 0 b a 0 0 c 1 a 0 0 0 0 0 0 0 b 1 d 
1 d 0 0 0 0 0 c a 0 0 0 0 0 0 0 0 0 0 0 0 1 d 0 0 1 0 1 0 0 0 0 0 0 0 0 0 1 a 0 0 0 0 0 0 0 0 0 b 1 
1 1 0 0 1 1 1 a 0 0 0 0 0 0 0 0 0 0 0 0 c 1 1 1 1 1 1 1 1 d 0 0 0 0 0 0 c 1 0 0 0 0 0 0 c 1 d 0 0 b 
a 0 0 0 0 0 0 0 0 0 0 0 0 0 0 0 0 0 0 0 2 a 0 0 b 1 0 b 1 1 d 0 0 0 0 0 1 a 0 0 0 0 0 0 1 0 1 0 0 0 
d 0 0 0 0 0 0 0 0 0 0 0 0 2 0 0 0 0 0 0 0 0 0 0 0 1 0 0 1 0 b d 0 0 0 0 1 0 0 0 0 0 0 0 b 1 a 0 0 0 
1 2 0 0 0 0 0 0 0 0 0 0 0 b d 0 0 0 0 0 0 0 0 0 c 1 0 c 1 0 0 b d 0 0 0 0 0 0 1 d 0 0 0 0 0 0 0 0 c 
1 1 d 0 c 2 0 0 0 0 0 0 0 0 1 0 0 0 0 0 0 c 1 1 1 1 1 1 1 0 0 0 1 d 0 0 0 0 0 b 1 d 0 0 0 0 0 0 c 1 
COLORS 
0 0 0 0 0 0 0 0 0 0 0 0 0 0 0 0 0 0 0 0 0 0 0 0 0 0 0 0 0 0 0 0 0 0 0 0 0 0 0 0 0 3 3 3 0 0 0 0 0 0 
0 0 0 0 0 0 0 0 0 0 0 0 0 0 0 0 0 0 0 0 0 0 0 0 0 0 0 0 0 0 0 0 0 0 0 0 0 0 0 0 3 3 3 3 3 0 0 0 0 0 
0 0 0 0 0 0 0 0 0 0 0 0 0 0 0 0 0 0 0 0 0 0 0 0 0 0 0 0 0 0 0 0 0 0 0 0 0 0 0 0 3 3 3 3 3 3 3 0 0 0 
0 0 0 0 0 0 0 0 0 0 0 0 0 0 0 0 0 0 0 0 0 0 0 0 0 0 0 0 0 0 0 0 0 0 0 0 0 0 0 0 0 0 0 0 0 0 3 3 0 0 
0 0 0 0 0 0 0 0 0 0 0 0 0 0 0 0 0 0 0 0 0 0 0 0 0 0 0 0 0 0 0 0 0 0 0 0 0 0 0 0 0 0 0 0 0 0 0 3 3 3 
0 0 0 0 0 0 0 0 0 0 0 0 0 0 0 0 0 0 0 0 0 0 0 0 0 0 0 0 0 0 0 0 0 0 0 0 0 0 0 0 0 0 0 0 0 0 0 0 0 0 
0 0 0 0 0 0 0 0 0 0 0 0 0 0 0 0 0 0 0 0 0 0 0 0 0 0 0 0 0 0 0 0 0 0 0 0 0 0 0 0 0 0 0 0 0 0 0 0 0 0 
0 0 0 0 0 0 0 0 0 0 0 0 0 0 0 0 0 0 0 0 0 0 0 0 0 0 0 0 0 0 0 0 0 0 0 0 0 0 0 0 0 0 0 0 0 0 0 0 0 0 
0 0 0 0 0 0 0 0 0 0 0 0 0 0 0 5 0 0 0 0 0 0 0 0 0 0 0 0 0 0 0 0 0 0 0 0 0 0 0 0 0 0 0 0 0 0 0 0 0 0 
0 0 0 0 0 0 0 0 0 0 0 0 0 0 0 0 0 0 0 0 0 0 0 0 0 0 0 0 0 0 0 0 0 0 0 0 0 0 0 0 3 0 0 0 0 0 0 0 0 0 
0 0 0 0 0 0 0 0 0 0 0 0 0 0 0 0 0 5 5 5 0 0 0 0 0 0 0 0 0 0 0 0 0 0 0 0 0 0 0 0 3 0 0 0 0 0 0 0 0 0 
0 0 0 0 0 0 0 0 0 0 0 0 0 0 0 0 5 0 0 0 0 0 0 0 0 0 0 0 0 0 0 0 0 0 0 0 0 0 0 0 3 0 0 0 0 0 0 0 0 0 
0 0 0 0 0 0 0 0 0 0 0 0 0 0 0 5 5 0 0 0 0 0 0 0 0 0 0 0 0 0 0 0 0 0 0 0 0 0 0 0 0 0 0 0 0 0 0 0 0 0 
0 0 0 0 0 0 0 0 0 0 0 0 0 0 0 0 5 5 0 0 0 0 0 0 0 0 0 0 0 0 0 0 0 0 0 0 0 0 0 0 0 0 0 0 0 0 0 0 0 0 
0 0 0 0 0 0 0 0 0 0 0 0 0 0 0 0 0 0 0 0 0 0 0 0 0 0 0 0 0 0 0 0 0 0 0 0 0 0 0 0 0 0 0 0 0 3 3 0 0 0 
0 0 0 0 0 0 0 0 0 0 0 0 0 0 0 0 0 0 0 0 0 0 0 0 0 0 0 0 0 0 0 0 0 0 0 0 0 0 0 0 0 0 0 3 3 3 3 0 0 0 
0 0 0 0 0 0 0 0 0 0 0 0 0 0 0 0 0 0 0 0 0 0 0 0 0 0 0 0 0 0 0 0 0 0 0 0 0 0 0 0 0 0 0 0 0 3 0 0 0 0 
0 0 0 0 0 0 0 0 0 0 0 0 0 0 0 0 0 0 0 0 0 0 0 0 0 0 0 0 0 3 0 0 0 0 0 0 0 0 3 0 0 0 0 0 0 0 0 0 0 0 
0 0 0 0 0 0 0 0 0 0 0 0 0 0 0 0 0 0 0 0 0 0 0 0 0 0 0 0 0 3 0 0 0 0 0 0 0 0 3 0 0 0 0 3 3 0 0 0 0 0 
0 0 0 0 0 0 0 0 0 0 0 0 0 0 0 0 0 0 0 0 0 0 0 0 0 0 0 0 0 3 0 0 0 0 0 0 0 0 3 3 0 0 0 3 3 3 3 3 3 3 
0 0 0 0 0 0 0 0 0 0 0 0 0 0 0 0 0 0 0 0 0 0 0 0 0 0 0 0 0 3 0 0 0 0 0 0 0 0 3 0 3 3 0 0 0 0 0 0 0 0 
0 0 0 0 0 0 0 0 0 0 0 0 0 0 0 0 0 0 0 0 0 0 0 0 0 0 0 0 0 0 0 0 0 0 0 0 0 0 3 0 0 0 0 0 0 0 0 0 0 0 
0 0 0 0 0 0 0 0 0 0 0 0 0 0 0 0 0 0 0 0 0 0 0 0 0 0 0 0 0 3 0 0 0 0 0 0 0 0 3 0 0 0 0 0 0 3 3 0 0 0 
0 0 0 0 0 0 0 0 0 0 0 0 0 0 0 0 0 0 0 0 0 0 0 0 0 0 0 0 0 3 0 0 0 0 3 3 0 0 3 0 0 0 0 0 3 3 0 0 0 0 
0 0 0 0 0 0 0 0 0 0 0 0 0 0 0 0 0 0 1 0 0 0 0 0 0 0 0 0 0 3 0 0 0 0 0 0 0 0 0 0 0 0 0 3 3 0 0 0 0 3 
0 0 0 0 0 0 0 0 0 0 0 0 0 0 0 0 0 0 1 0 0 0 0 0 0 0 0 0 0 0 0 0 0 0 3 3 3 3 0 0 0 0 0 0 0 0 0 0 3 3 
0 0 0 0 0 0 0 0 0 0 0 0 0 0 0 0 0 0 0 0 0 0 0 0 0 0 0 0 0 0 0 3 3 3 0 0 0 0 0 0 0 0 0 0 0 3 0 0 3 3 
0 0 0 0 0 0 0 0 0 0 0 0 0 0 0 0 0 0 0 0 0 0 0 0 0 0 0 0 0 0 0 3 0 3 0 0 0 0 0 0 0 0 0 0 3 3 0 0 0 0 
0 0 0 0 0 0 0 0 0 0 0 0 0 0 0 0 0 0 0 0 0 0 0 0 0 0 0 0 0 0 0 3 0 3 0 0 0 0 0 0 0 0 3 0 0 3 0 3 3 0 
0 0 0 0 0 0 0 0 0 0 0 0 0 0 0 0 0 0 0 0 0 0 0 0 0 0 0 0 0 0 0 0 0 3 0 3 3 3 0 0 0 0 0 0 0 3 0 3 3 0 
0 0 0 0 0 0 0 0 0 0 0 0 0 0 0 0 0 0 0 0 0 0 0 0 0 0 0 0 0 0 0 0 0 3 0 0 3 3 0 0 0 0 0 0 0 3 0 0 0 3 
0 0 0 0 0 0 0 0 0 0 0 0 0 0 0 0 0 0 0 0 0 0 0 0 0 0 0 0 0 0 0 3 3 3 0 0 0 0 3 3 0 0 0 0 0 3 3 3 0 3 
0 0 0 0 0 0 0 0 0 0 0 0 0 0 0 0 0 0 0 0 0 0 0 0 0 0 0 0 0 0 0 3 3 3 0 0 0 3 3 0 0 0 0 0 0 3 3 3 0 0 
0 0 0 0 0 0 0 0 0 0 0 0 0 0 0 0 0 0 0 0 0 0 0 0 3 0 0 0 0 0 0 0 0 0 0 0 3 3 0 0 0 0 0 0 3 3 0 0 0 0 
0 0 0 0 0 0 0 0 0 0 0 0 0 0 0 0 0 0 0 0 0 0 0 0 0 0 0 0 0 0 0 0 0 0 0 3 3 0 0 0 0 0 0 0 3 3 0 0 0 0 
0 0 0 0 0 0 0 0 0 0 0 0 0 0 0 0 0 0 0 0 0 0 0 0 0 0 0 0 0 0 3 3 0 0 3 3 0 0 0 0 0 0 0 0 0 0 0 0 0 0 
0 0 0 0 0 0 0 0 0 0 0 0 0 0 0 0 0 0 0 0 0 0 0 0 0 0 0 0 3 0 3 3 0 3 3 0 0 0 0 0 0 0 0 0 0 0 0 0 0 0 
0 0 0 0 0 0 0 0 0 0 0 0 0 0 0 0 0 0 0 0 0 0 0 0 0 0 0 0 0 0 3 3 0 3 0 0 0 0 0 0 0 0 0 0 0 0 0 0 0 0 
0 0 0 0 0 0 0 0 0 0 0 0 0 0 0 0 0 0 0 0 0 0 0 0 0 0 0 0 0 0 0 0 0 0 0 0 0 0 0 0 0 0 0 0 0 0 0 0 0 0 
0 0 0 0 0 0 0 0 0 0 0 0 0 0 0 0 0 0 0 0 0 0 0 0 0 0 0 0 0 0 0 0 0 0 0 0 0 0 0 0 0 0 0 0 0 0 0 0 0 0 
0 0 0 0 0 0 0 0 0 0 0 0 0 0 0 0 0 0 0 0 0 0 0 0 0 0 0 0 0 0 0 0 0 0 0 0 0 0 0 0 0 0 0 0 0 0 0 0 0 0 
0 0 0 0 0 0 0 0 0 0 0 0 0 0 0 0 0 0 0 0 0 0 0 0 0 0 0 0 0 0 0 0 0 0 0 0 0 0 0 0 0 0 0 0 0 0 0 0 0 0 
0 0 0 0 0 0 0 0 0 0 0 0 0 0 0 0 0 0 0 0 0 0 0 0 0 0 0 0 0 0 0 0 0 0 0 0 0 0 0 0 0 0 0 0 0 0 0 0 0 0 
0 0 0 0 0 0 0 0 0 0 0 0 0 0 0 0 0 0 0 0 0 0 0 0 0 5 0 1 0 0 0 0 0 0 0 0 0 0 0 0 0 0 0 0 0 0 0 0 0 0 
0 0 0 0 0 0 0 0 0 0 0 0 0 0 0 0 0 0 0 0 0 0 0 0 0 5 0 1 0 0 0 0 0 0 0 0 0 0 0 0 0 0 0 0 0 0 0 0 0 0 
0 0 0 0 0 0 0 0 0 0 0 0 0 0 0 0 0 0 0 0 0 0 0 0 0 0 0 0 0 3 0 0 0 0 0 0 0 0 0 0 0 0 0 0 3 3 3 0 0 0 
0 0 0 0 0 0 0 0 0 0 0 0 0 0 0 0 0 0 0 0 0 0 0 0 1 1 0 0 0 3 3 0 0 0 0 0 0 0 0 0 0 0 0 0 3 0 3 0 0 0 
0 0 0 0 0 0 0 0 0 0 0 0 0 0 0 0 0 0 0 0 0 0 0 0 1 1 0 0 0 3 3 3 0 0 0 0 0 0 0 0 0 0 0 0 3 3 3 0 0 0 
0 0 0 0 0 0 0 0 0 0 0 0 0 0 0 0 0 0 0 0 0 0 0 0 1 1 0 0 0 3 3 3 3 0 0 0 0 0 0 0 0 0 0 0 0 0 0 0 0 0 
0 0 0 0 0 0 0 0 0 0 0 0 0 0 0 0 0 0 0 0 0 0 0 0 0 0 0 0 0 3 3 3 3 3 0 0 0 0 0 0 0 0 0 0 0 0 0 0 0 0 
SPAWNPOINT 1 1 
TURRET CD 1 BV 5 POS 1 8 DIR 0 W 3.14159 END
TURRET CD 1 BV 5 POS 3 10 DIR 0 W 3.14159 END
TURRET CD 1 BV 5 POS 6 10 DIR 0 W 3.14159 END
TURRET CD 1 BV 5 POS 3 6 DIR 0 W 3.14159 END
TURRET CD 1 BV 5 POS 1 12 DIR 0 W 3.14159 END
TURRET CD 1 BV 5 POS 4 13 DIR 0 W 3.14159 END
BONUS POS 9 14 TYPE shield END
BONUS POS 4 26 TYPE shield END
TURRET CD 0.7 BV 7 POS 10 35 DIR 4.71239 W -8.79646 END
TURRET CD 0.7 BV 7 POS 2 37 DIR 4.71239 W -8.79646 END
TURRET CD 0.7 BV 7 POS 7 40 DIR 4.71239 W -8.79646 END
GENERATOR COLOR 1 POS 20 23 DIR 0 W 0 END
BONUS POS 26 47 TYPE shield END
BONUS POS 23 47 TYPE shield END
TURRET CD 0.5 BV 5 POS 10 32 DIR 0 W 11.3097 END
TURRET CD 0.5 BV 5 POS 2 41 DIR 0 W 11.3097 END
TURRET CD 0.5 BV 5 POS 10 38 DIR 0 W 11.3097 END
TURRET CD 0.5 BV 5 POS 3 34 DIR 0 W 11.3097 END
ROBOT CD 0.5 BV 2.5 MF 0 SHIELDS 0 POS 10 46 DIR 3.14159 W 0 END
ROCKET_LAUNCHER CD 0.85 BV 2.5 DIRECTIONS 3 POS 17 45 DIR 3.14159 W 32.6726 END
LASER_CARRIER DIRECTIONS 3 POS 20 37 DIR 3.14159 W 0.628319 END
TURRET CD 1 BV 7 POS 16 33 DIR 0.523599 W 6.28319 END
TURRET CD 1 BV 7 POS 20 30 DIR 0.523599 W 6.28319 END
TURRET CD 1 BV 7 POS 16 28 DIR 0.523599 W 6.28319 END
ROCKET_LAUNCHER CD 1 BV 4 DIRECTIONS 1 POS 6 29 DIR 4.71239 W 0 END
ROCKET_LAUNCHER CD 0.8 BV 3.5 DIRECTIONS 1 POS 9 29 DIR 4.71239 W 0 END
ROCKET_LAUNCHER CD 0.7 BV 4.5 DIRECTIONS 1 POS 12 29 DIR 4.71239 W 0 END
ROCKET_LAUNCHER CD 1.4 BV 4.5 DIRECTIONS 1 POS 12 41 DIR 2.35619 W 0 END
ROCKET_LAUNCHER CD 1.65 BV 3.5 DIRECTIONS 1 POS 13 49 DIR 3.40339 W 0 END
TURRET CD 0.45 BV 0.5 POS 11 9 DIR 0 W 16.9646 END
TURRET CD 0.45 BV 0.5 POS 10 12 DIR 0 W 16.9646 END
TURRET CD 0.45 BV 0.5 POS 10 18 DIR 0 W 16.9646 END
TURRET CD 2 BV 10 POS 15 5 DIR 5.75959 W 3.76991 END
TURRET CD 2 BV 10 POS 14 7 DIR 5.75959 W 3.76991 END
TURRET CD 2 BV 10 POS 32 6 DIR 5.75959 W 3.76991 END
GENERATOR COLOR 5 POS 17 10 DIR 0 W 0 END
GENERATOR COLOR 5 POS 15 8 DIR 0 W 0 END
TURRET CD 0.85 BV 4.5 POS 19 6 DIR 4.18879 W -6.9115 END
TURRET CD 0.85 BV 4.5 POS 23 10 DIR 4.18879 W -6.9115 END
TURRET CD 0.85 BV 4.5 POS 20 15 DIR 4.18879 W -6.9115 END
TURRET CD 0.85 BV 4.5 POS 18 13 DIR 4.18879 W -6.9115 END
TURRET CD 0.85 BV 4.5 POS 20 10 DIR 4.18879 W -6.9115 END
TURRET CD 0.95 BV 7 POS 21 12 DIR 0.785398 W 3.14159 END
TURRET CD 0.95 BV 7 POS 30 9 DIR 0.785398 W 3.14159 END
TURRET CD 0.95 BV 7 POS 27 10 DIR 0.785398 W 3.14159 END
ROCKET_LAUNCHER CD 3.2 BV 1 DIRECTIONS 1 POS 37 0 DIR 3.14159 W 0 END
ROCKET_LAUNCHER CD 3.2 BV 1 DIRECTIONS 1 POS 37 2 DIR 3.14159 W 0 END
ROCKET_LAUNCHER CD 3.15 BV 1 DIRECTIONS 1 POS 35 1 DIR 3.14159 W 0 END
ROBOT CD 1 BV 2.5 MF 0 SHIELDS 0 POS 25 25 DIR 4.45059 W -3.14159 END
ROBOT CD 1 BV 2.5 MF 0 SHIELDS 0 POS 28 27 DIR 4.45059 W 3.76991 END
ROBOT CD 1 BV 2.5 MF 0 SHIELDS 0 POS 25 30 DIR 0.785398 W -5.65487 END
ROBOT CD 0.4 BV 2.5 MF 0 SHIELDS 0 POS 25 34 DIR 0.785398 W -10.6814 END
ROBOT CD 0.4 BV 2.5 MF 0 SHIELDS 0 POS 28 31 DIR 0.785398 W -10.6814 END
EXIT 45 46 
GENERATOR COLOR 3 POS 26 40 DIR 0 W 0 END
TURRET CD 1 BV 5 POS 31 42 DIR 0 W 6.28319 END
TURRET CD 1 BV 5 POS 34 45 DIR 0 W 6.28319 END
TURRET CD 1 BV 5 POS 35 40 DIR 0 W 6.28319 END
TURRET CD 1 BV 7.5 POS 40 37 DIR 0 W 6.28319 END
TURRET CD 1 BV 7.5 POS 44 38 DIR 4.97419 W 6.28319 END
TURRET CD 1 BV 7.5 POS 48 36 DIR 4.97419 W -6.28319 END
TURRET CD 1 BV 7.5 POS 42 28 DIR 4.97419 W -6.28319 END
TURRET CD 1 BV 7.5 POS 44 29 DIR 4.97419 W -6.28319 END
TURRET CD 1 BV 7.5 POS 42 31 DIR 4.97419 W -6.28319 END
TURRET CD 1 BV 7.5 POS 43 33 DIR 4.97419 W -6.28319 END
BONUS POS 45 10 TYPE shield END
TURRET CD 0.2 BV 4 POS 41 16 DIR 0 W 11.9381 END
TURRET CD 0.2 BV 4 POS 44 21 DIR 0 W 11.9381 END
TURRET CD 0.2 BV 4 POS 40 23 DIR 0 W 11.9381 END
TURRET CD 0.2 BV 4 POS 40 18 DIR 0 W 11.9381 END
TURRET CD 0.2 BV 4 POS 43 15 DIR 0 W 11.9381 END
TURRET CD 0.2 BV 4 POS 46 17 DIR 0 W 11.9381 END
TURRET CD 1 BV 10 POS 41 1 DIR 0 W 1.25664 END
TURRET CD 1 BV 10 POS 48 3 DIR 0 W -1.25664 END
TURRET CD 1 BV 15 POS 42 3 DIR 0 W 0.628319 END
TURRET CD 1 BV 15 POS 39 9 DIR 0 W -0.628319 END
TURRET CD 1 BV 15 POS 34 12 DIR 0 W -1.25664 END
TURRET CD 1 BV 15 POS 35 17 DIR 0 W 0.628319 END
TURRET CD 1 BV 8 POS 32 28 DIR 0 W 6.28319 END
TURRET CD 1 BV 8 POS 31 30 DIR 0 W 6.28319 END
TURRET CD 1 BV 8 POS 38 33 DIR 0 W 6.28319 END
TURRET CD 1 BV 8 POS 36 35 DIR 0 W -6.28319 END
TURRET CD 1 BV 8 POS 35 24 DIR 0 W -6.28319 END
TURRET CD 1 BV 8 POS 34 37 DIR 0 W -6.28319 END
LASER_CARRIER DIRECTIONS 6 POS 37 20 DIR 0 W 0.628319 END
TURRET CD 1 BV 4 POS 28 36 DIR 0 W 12.5664 END
TURRET CD 1 BV 4 POS 30 39 DIR 0 W 12.5664 END
TURRET CD 1 BV 4 POS 32 34 DIR 0 W -10.0531 END
TURRET CD 1 BV 4 POS 35 32 DIR 0 W -10.0531 END
TURRET CD 1 BV 4 POS 38 28 DIR 0 W -10.0531 END
TURRET CD 1 BV 4 POS 37 26 DIR 0 W -10.0531 END
ROCKET_LAUNCHER CD 1.3 BV 3 DIRECTIONS 1 POS 25 18 DIR 0 W 0 END
ROCKET_LAUNCHER CD 1.2 BV 3.5 DIRECTIONS 1 POS 26 20 DIR 0 W 0 END
ROCKET_LAUNCHER CD 1.5 BV 5 DIRECTIONS 1 POS 26 22 DIR 0 W 0 END
ROCKET_LAUNCHER CD 1.95 BV 2.5 DIRECTIONS 1 POS 27 24 DIR 0 W 0 END
END