50 50
0 b 1 1 1 1 1 1 1 1 1 1 1 1 1 1 1 a 0 b 1 0 0 0 0 0 0 0 0 0 0 0 0 b 1 0 0 0 0 0 0 0 0 0 0 0 0 0 0 0 
0 0 0 b 1 1 1 a 0 0 0 0 0 0 b 1 1 0 0 0 1 0 0 0 0 0 0 0 0 0 0 0 0 0 1 0 0 0 0 0 0 0 0 0 0 0 0 0 0 0 
d 0 0 0 0 b 1 0 0 0 0 0 0 0 0 b a 0 0 0 1 0 0 1 d 0 c 1 d 0 c 1 0 0 1 0 0 0 0 0 0 0 0 0 0 0 0 0 0 0 
1 d 0 0 0 0 1 d 0 0 0 0 0 0 0 0 0 0 0 0 1 0 0 0 b 1 a 0 b 1 1 a 0 0 1 0 0 0 0 0 0 0 0 0 0 0 0 0 0 0 
1 1 2 0 0 0 b 1 0 0 0 0 0 0 0 0 0 0 0 0 1 0 0 0 0 1 0 0 0 b 1 d 0 c 1 0 0 0 0 0 0 0 0 0 0 0 0 0 0 0 
0 b 1 d 0 0 0 0 0 0 0 0 0 0 0 c d 0 0 0 1 0 0 0 0 0 0 0 0 0 b 1 1 1 1 1 d 0 0 0 0 0 0 0 0 0 0 0 0 0 
0 0 b 1 d 0 0 0 0 0 0 0 0 0 0 1 1 0 0 0 1 0 0 0 0 0 0 0 0 0 0 0 b a 0 0 b d 0 0 0 0 0 0 0 0 0 0 0 0 
0 0 0 0 b 2 0 0 0 0 1 d 0 0 c 1 1 d 0 c 1 0 0 0 0 0 0 0 0 0 0 0 0 0 0 0 0 b d 0 0 0 0 0 0 0 0 0 0 0 
0 1 0 0 0 b d 0 0 0 b 1 1 1 1 1 2 1 1 1 1 0 0 0 0 0 0 0 0 0 0 0 0 0 c d 0 0 1 0 0 0 0 0 0 0 0 0 0 0 
0 1 0 0 0 0 b 2 0 0 0 0 0 0 0 2 0 2 0 2 a 0 0 c 2 0 0 0 0 0 0 0 0 c 1 a 0 0 1 0 0 0 0 0 0 0 0 0 0 0 
0 0 0 0 0 0 0 b d 0 0 0 0 0 0 0 0 0 0 0 0 0 0 2 a 0 0 0 0 0 0 0 0 1 2 0 0 0 1 0 0 0 0 0 0 0 0 0 0 0 
0 0 0 0 0 0 0 0 b 1 2 d c 2 0 2 0 2 0 2 d 0 0 0 0 0 0 0 0 0 0 0 0 1 0 0 0 2 1 0 0 0 0 0 0 0 0 0 0 0 
0 1 0 0 0 0 1 d 0 0 0 b 1 1 0 1 0 1 0 1 1 0 0 0 0 0 0 0 0 c d 0 0 1 0 0 0 1 1 0 0 0 0 0 0 0 0 0 0 0 
0 1 0 0 0 0 0 b d 0 0 c 1 1 0 1 0 1 0 1 1 0 0 0 0 0 0 0 c 1 a 0 0 1 d 0 0 b 1 0 0 0 0 0 0 0 0 0 0 0 
0 1 0 0 0 0 0 0 b 1 1 1 1 1 0 1 0 1 0 1 1 0 0 0 0 0 0 0 b a 0 0 0 1 1 2 0 0 1 0 0 0 0 0 0 0 0 0 0 0 
0 1 0 0 0 0 0 0 0 0 0 0 0 b 1 1 1 1 1 a b d 0 0 0 0 0 0 0 0 0 0 c 1 1 a 0 0 1 0 0 0 0 0 0 0 0 0 0 0 
0 b d 0 0 0 0 0 0 0 0 0 0 0 0 0 0 0 0 0 0 b 1 1 1 1 d 0 0 0 0 c a 0 0 0 0 2 1 d 0 0 0 0 0 0 0 0 0 0 
0 0 b 1 1 1 1 1 1 1 d 0 0 0 0 0 0 0 0 0 0 0 0 0 0 b 1 1 1 1 1 2 0 0 0 0 0 1 2 2 d 0 0 0 0 0 0 0 0 0 
0 0 0 0 0 0 0 0 0 0 b 2 0 0 0 1 1 1 1 d 0 0 0 0 0 0 0 2 0 0 0 0 0 0 0 0 0 0 0 2 2 d 0 0 0 0 0 0 0 0 
0 0 0 0 0 0 0 0 0 0 0 0 0 0 0 0 0 0 b 1 2 0 0 0 0 0 0 0 0 0 0 0 0 0 0 0 0 0 0 0 b 2 d 0 0 0 0 0 0 0 
0 c 1 1 1 1 1 1 1 1 1 1 1 1 d 0 0 0 0 1 0 0 0 0 0 0 0 0 0 0 0 0 0 0 0 0 0 0 0 0 0 2 2 d 0 0 0 0 0 0 
1 a 0 0 0 0 0 0 0 0 0 0 0 0 b d 0 0 0 1 0 0 0 0 0 0 0 0 0 0 2 0 0 0 0 0 0 0 0 0 0 0 1 1 d 0 0 0 0 0 
0 0 0 0 0 0 0 0 0 0 0 0 0 0 0 b d 0 0 b 2 0 0 0 0 0 0 0 0 0 0 0 0 0 0 0 0 0 0 0 0 0 1 a b d 0 0 0 0 
0 0 0 0 0 0 0 0 0 0 0 0 0 0 0 0 1 0 0 0 b 2 0 0 0 0 0 0 0 0 0 0 0 0 0 0 2 0 0 0 0 2 1 0 0 1 0 0 0 0 
0 0 0 0 0 0 0 0 b 0 0 0 0 0 0 0 1 0 0 0 0 b d 0 0 0 0 0 0 0 0 0 0 0 0 0 0 0 0 0 0 b a 0 0 1 0 0 0 0 
0 0 0 0 0 0 0 0 0 0 0 0 0 0 0 0 0 0 0 0 0 0 b 2 0 0 0 0 0 0 0 0 0 0 0 0 0 0 0 0 0 0 0 0 c 1 0 0 0 0 
0 0 0 0 0 0 a 0 d 0 c 0 0 0 0 0 0 0 0 0 0 0 0 1 d 0 0 0 0 0 0 0 0 0 0 0 0 0 0 0 0 0 c 1 1 a 0 0 0 0 
0 0 0 0 0 0 0 0 0 0 0 0 0 0 0 0 0 0 0 0 0 0 0 b 1 2 0 0 0 0 0 0 0 0 0 0 0 0 0 0 0 c 1 2 a 0 0 0 0 0 
0 0 0 0 0 0 0 0 0 0 0 0 0 0 0 0 0 0 0 0 0 0 0 0 b 1 2 0 0 0 2 0 0 0 2 0 0 0 0 0 2 2 2 a 0 0 0 0 0 0 
0 0 0 0 0 0 0 0 0 0 0 0 0 0 0 0 0 0 0 0 0 0 0 0 0 b 1 1 1 1 1 1 1 1 1 1 1 1 1 1 1 1 a 0 0 0 0 0 0 0 
0 0 0 0 0 0 0 0 0 0 0 0 0 0 0 0 0 0 0 0 0 0 0 0 0 0 0 0 0 0 0 0 0 0 0 0 0 0 0 0 0 0 0 0 0 0 0 0 0 0 
0 0 0 0 0 0 0 0 0 0 0 0 0 0 0 0 0 0 0 0 0 0 0 0 0 0 0 0 0 0 0 0 0 0 0 0 0 0 0 0 0 0 0 0 0 0 0 0 0 0 
0 0 0 0 0 0 0 0 0 0 0 0 0 0 0 0 0 0 0 0 0 0 0 0 0 0 0 0 0 0 0 0 0 0 0 0 0 0 0 0 0 0 0 0 0 0 0 0 0 0 
0 0 0 0 0 0 0 0 0 0 0 0 0 0 0 0 0 0 0 0 0 0 0 0 0 0 0 0 0 0 0 0 0 0 0 0 0 0 0 0 0 0 0 0 0 0 0 0 0 0 
0 0 0 0 0 0 0 0 0 0 0 0 0 0 0 0 0 0 0 0 0 0 0 0 0 0 0 0 0 0 0 0 0 0 0 0 0 0 0 0 0 0 0 0 0 0 0 0 0 0 
0 0 0 0 0 0 0 0 0 0 0 0 0 0 0 0 0 0 0 0 0 0 0 0 0 0 0 0 0 0 0 0 0 0 0 0 0 0 0 0 0 0 0 0 0 0 0 0 0 0 
0 0 0 0 0 0 0 0 0 0 0 0 0 0 0 0 0 0 0 0 0 0 0 0 0 0 0 0 0 0 0 0 0 0 0 0 0 0 0 0 0 0 0 0 0 0 0 0 0 0 
0 0 0 0 0 0 0 0 0 0 0 0 0 0 0 0 0 0 0 0 0 0 0 0 0 0 0 0 0 0 0 0 0 0 0 0 0 0 0 0 0 0 0 0 0 0 0 0 0 0 
0 0 0 0 0 0 0 0 0 0 0 0 0 0 0 0 0 0 0 0 0 0 0 0 0 0 0 0 0 0 0 0 0 0 0 0 0 0 0 0 0 0 0 0 0 0 0 0 0 0 
0 0 0 0 0 0 0 0 0 0 0 0 0 0 0 0 0 0 0 0 0 0 0 0 0 0 0 0 0 0 0 0 0 0 0 0 0 0 0 0 0 0 0 0 0 0 0 0 0 0 
0 0 0 0 0 0 0 0 0 0 0 0 0 0 0 0 0 0 0 0 0 0 0 0 0 0 0 0 0 0 0 0 0 0 0 0 0 0 0 0 0 0 0 0 0 0 0 0 0 0 
0 0 0 0 0 0 0 0 0 0 0 0 0 0 0 0 0 0 0 0 0 0 0 0 0 0 0 0 0 0 0 0 0 0 0 0 0 0 0 0 0 0 0 0 0 0 0 0 0 0 
0 0 0 0 0 0 0 0 0 0 0 0 0 0 0 0 0 0 0 0 0 0 0 0 0 0 0 0 0 0 0 0 0 0 0 0 0 0 0 0 0 0 0 0 0 0 0 0 0 0 
0 0 0 0 0 0 0 0 0 0 0 0 0 0 0 0 0 0 0 0 0 0 0 0 0 0 0 0 0 0 0 0 0 0 0 0 0 0 0 0 0 0 0 0 0 0 0 0 0 0 
0 0 0 0 0 0 0 0 0 0 0 0 0 0 0 0 0 0 0 0 0 0 0 0 0 0 0 0 0 0 0 0 0 0 0 0 0 0 0 0 0 0 0 0 0 0 0 0 0 0 
0 0 0 0 0 0 0 0 0 0 0 0 0 0 0 0 0 0 0 0 0 0 0 0 0 0 0 0 0 0 0 0 0 0 0 0 0 0 0 0 0 0 0 0 0 0 0 0 0 0 
0 0 0 0 0 0 0 0 0 0 0 0 0 0 0 0 0 0 0 0 0 0 0 0 0 0 0 0 0 0 0 0 0 0 0 0 0 0 0 0 0 0 0 0 0 0 0 0 0 0 
0 0 0 0 0 0 0 0 0 0 0 0 0 0 0 0 0 0 0 0 0 0 0 0 0 0 0 0 0 0 0 0 0 0 0 0 0 0 0 0 0 0 0 0 0 0 0 0 0 0 
0 0 0 0 0 0 0 0 0 0 0 0 0 0 0 0 0 0 0 0 0 0 0 0 0 0 0 0 0 0 0 0 0 0 0 0 0 0 0 0 0 0 0 0 0 0 0 0 0 0 
0 0 0 0 0 0 0 0 0 0 0 0 0 0 0 0 0 0 0 0 0 0 0 0 0 0 0 0 0 0 0 0 0 0 0 0 0 0 0 0 0 0 0 0 0 0 0 0 0 0 
SPAWNPOINT 1 1 
LASER_CARRIER DIRECTIONS 6 POS 11 3 DIR 0 W -1.25664 END
BONUS POS 18 1 TYPE shield END
ROCKET_LAUNCHER CD 0.9 BV 3 DIRECTIONS 1 POS 16 14 DIR 4.71239 W 0 END
ROCKET_LAUNCHER CD 0.8 BV 4 DIRECTIONS 1 POS 18 14 DIR 4.71239 W 0 END
TURRET CD 1 BV 7 POS 24 6 DIR 4.71239 W 6.28319 END
TURRET CD 1 BV 7 POS 30 9 DIR 2.87979 W 6.28319 END
TURRET CD 1 BV 7 POS 27 14 DIR 0.523599 W 6.28319 END
TURRET CD 1 BV 7 POS 27 3 DIR 6.02139 W 6.28319 END
TURRET CD 1 BV 7 POS 22 14 DIR 3.92699 W 6.28319 END
TURRET CD 1 BV 12 POS 29 5 DIR 2.35619 W 0 END
TURRET CD 1 BV 12 POS 28 12 DIR 3.92699 W 0 END
BONUS POS 32 3 TYPE shield END
TURRET CD 0.4 BV 4 POS 25 2 DIR 3.92699 W 18.8496 END
TURRET CD 0.4 BV 4 POS 29 2 DIR 3.92699 W 18.8496 END
TURRET CD 0.4 BV 4 POS 27 0 DIR 3.92699 W 18.8496 END
TURRET CD 0.4 BV 4 POS 23 0 DIR 3.92699 W 18.8496 END
TURRET CD 0.4 BV 4 POS 31 0 DIR 3.92699 W 18.8496 END
TURRET CD 0.4 BV 4 POS 27 8 DIR 3.92699 W 18.8496 END
BONUS POS 18 6 TYPE shield END
ROCKET_LAUNCHER CD 5 BV 4 DIRECTIONS 5 POS 25 21 DIR 3.92699 W 18.8496 END
ROCKET_LAUNCHER CD 3.95 BV 4 DIRECTIONS 4 POS 33 25 DIR 3.92699 W -15.708 END
ROCKET_LAUNCHER CD 2.5 BV 3.5 DIRECTIONS 1 POS 28 27 DIR 4.97419 W 0 END
ROCKET_LAUNCHER CD 2.5 BV 3.5 DIRECTIONS 1 POS 39 26 DIR 4.18879 W 0 END
ROCKET_LAUNCHER CD 2.5 BV 3.5 DIRECTIONS 1 POS 20 20 DIR 0 W 0 END
ROCKET_LAUNCHER CD 2.5 BV 1.5 DIRECTIONS 1 POS 23 23 DIR 5.75959 W 0 END
ROCKET_LAUNCHER CD 2.5 BV 1.5 DIRECTIONS 1 POS 41 22 DIR 3.66519 W 0 END
ROCKET_LAUNCHER CD 1 BV 5 DIRECTIONS 1 POS 36 28 DIR 4.45059 W 0 END
ROCKET_LAUNCHER CD 0.95 BV 5 DIRECTIONS 1 POS 33 28 DIR 3.92699 W 0 END
BONUS POS 44 23 TYPE shield END
TURRET CD 0.2 BV 20 POS 0 19 DIR 0 W 0 END
TURRET CD 0.2 BV 20 POS 0 6 DIR 1.5708 W 0 END
ROCKET_LAUNCHER CD 0.9 BV 4.5 DIRECTIONS 1 POS 14 14 DIR 4.71239 W 0 END
TURRET CD 0.5 BV 20 POS 9 13 DIR 3.92699 W 0 END
TURRET CD 0.5 BV 5 POS 3 13 DIR 3.92699 W 12.5664 END
TURRET CD 0.5 BV 5 POS 4 12 DIR 3.92699 W 12.5664 END
TURRET CD 1 BV 5 POS 5 31 DIR 0 W 0 END
ROCKET_LAUNCHER CD 1 BV 5 DIRECTIONS 1 POS 7 31 DIR 0 W 0 END
END